Word	IPA transcription
для	d̪ lʲ ɑ
введення	v v ɛ d̪ ɛ n̪ n̪ʲ ɑ
деяких	d̪ ɛ ɑ k ɪ x
норм	n̪ ɔ r m
Податкового	p ɔ d̪ ɑ t̪ k ɔ v ɔ ɦ ɔ
кодексу	k ɔ d̪ ɛ k s̪ u
також	t̪ ɑ k ɔ ʒ
потрібен	p ɔ t̪ rʲ i b ɛ n̪
час	t̪ ʃ ɑ s̪
Віктор	v i k t̪ ɔ r
і	i
Олена	ɔ l̪ ɛ n̪ ɑ
мене	m ɛ n̪ ɛ
підтримали	p i d̪ t̪ r ɪ m ɑ l̪ ɪ
там	t̪ ɑ m
власне	v l̪ ɑ s̪ n̪ ɛ
вони	v ɔ n̪ ɪ
й	j
перебували	p ɛ r ɛ b u v ɑ l̪ ɪ
весь	v ɛ s̪
цей	t̪s̪ ɛ j
все	v s̪ ɛ
правильно	p r ɑ v ɪ lʲ n̪ ɔ
він	v i n̪
сказав	s̪ k ɑ z̪ ɑ v
виходячи	v ɪ x ɔ d̪ʲ ɑ t̪ ʃ ɪ
з	z̪
інтересів	i n̪ t̪ ɛ r ɛ s̪ i v
України	u k r ɑ j i n̪ ɪ
але	ɑ l̪ ɛ
ми	m ɪ
будемо	b u d̪ ɛ m ɔ
стояти	s̪ t̪ ɔ ɑ t̪ ɪ
далі	d̪ ɑ lʲ i
та	t̪ ɑ
інші	i n̪ ʃ i
хлопці	x l̪ ɔ p t̪s̪ʲ i
нашої	n̪ ɑ ʃ ɔ j i
дільниці	d̪ʲ i lʲ n̪ ɪ t̪s̪ʲ i
всі	v s̪ i
вийшли	v ɪ j ʃ l̪ ɪ
відомих	v i d̪ ɔ m ɪ x
людей	lʲ u d̪ ɛ j
маю	m ɑ u
на	n̪ ɑ
увазі	u v ɑ z̪ʲ i
мають	m ɑ u t̪
велику	v ɛ l̪ ɪ k u
силу	s̪ ɪ l̪ u
над	n̪ ɑ d̪
людиною	lʲ u d̪ ɪ n̪ ɔ u
коли	k ɔ l̪ ɪ
почав	p ɔ t̪ ʃ ɑ v
заробляти	z̪ ɑ r ɔ b lʲ ɑ t̪ ɪ
добре	d̪ ɔ b r ɛ
вирішив	v ɪ rʲ i ʃ ɪ v
допомогти	d̪ ɔ p ɔ m ɔ ɦ t̪ ɪ
цій	t̪s̪ʲ i j
країні	k r ɑ j i n̪ʲ i
працювати	p r ɑ t̪s̪ʲ u v ɑ t̪ ɪ
не	n̪ ɛ
завдяки	z̪ ɑ v d̪ʲ ɑ k ɪ
а	ɑ
всупереч	v s̪ u p ɛ r ɛ t̪ ʃ
це	t̪s̪ ɛ
питання	p ɪ t̪ ɑ n̪ n̪ʲ ɑ
до	d̪ ɔ
міської	m i s̪ k ɔ j i
влади	v l̪ ɑ d̪ ɪ
йому	j ɔ m u
вдалося	v d̪ ɑ l̪ ɔ s̪ ɑ
втекти	v t̪ ɛ k t̪ ɪ
колонії	k ɔ l̪ ɔ n̪ʲ i j i
всього	v s̪ ɔ ɦ ɔ
в	v
області	ɔ b l̪ ɑ s̪ t̪ i
бракує	b r ɑ k u ɛ
лікарів	lʲ i k ɑ rʲ i v
про	p r ɔ
що	ʃ t̪ ʃ ɔ
заявив	z̪ ɑ ɑ v ɪ v
перебуваючи	p ɛ r ɛ b u v ɑ u t̪ ʃ ɪ
Донецьку	d̪ ɔ n̪ ɛ t̪s̪ʲ k u
ринку	r ɪ n̪ k u
тільки	t̪ i lʲ k ɪ
говорять	ɦ ɔ v ɔ rʲ ɑ t̪
того	t̪ ɔ ɦ ɔ
ж	ʒ
чоловік	t̪ ʃ ɔ l̪ ɔ v i k
навіть	n̪ ɑ v i t̪
громадянин	ɦ r ɔ m ɑ d̪ʲ ɑ n̪ ɪ n̪
бачимо	b ɑ t̪ ʃ ɪ m ɔ
як	j ɑ k
формується	f ɔ r m u ɛ t̪ s̪ ɑ
нова	n̪ ɔ v ɑ
еліта	ɛ lʲ i t̪ ɑ
сам	s̪ ɑ m
по	p ɔ
собі	s̪ ɔ b i
факт	f ɑ k t̪
ніби	n̪ʲ i b ɪ
нічого	n̪ʲ i t̪ ʃ ɔ ɦ ɔ
значить	z̪ n̪ ɑ t̪ ʃ ɪ t̪
так	t̪ ɑ k
було	b u l̪ ɔ
зі	z̪ʲ i
мною	m n̪ ɔ u
однак	ɔ d̪ n̪ ɑ k
результатів	r ɛ z̪ u lʲ t̪ ɑ t̪ i v
дав	d̪ ɑ v
сьогодні	s̪ ɔ ɦ ɔ d̪ n̪ʲ i
стан	s̪ t̪ ɑ n̪
наших	n̪ ɑ ʃ ɪ x
доріг	d̪ ɔ rʲ i ɦ
відповідає	v i d̪ p ɔ v i d̪ ɑ ɛ
сучасним	s̪ u t̪ ʃ ɑ s̪ n̪ ɪ m
вимогам	v ɪ m ɔ ɦ ɑ m
цього	t̪s̪ʲ ɔ ɦ ɔ
у	u
державі	d̪ ɛ r ʒ ɑ v i
поки	p ɔ k ɪ
хай	x ɑ j
вважають	v v ɑ ʒ ɑ u t̪
його	j ɔ ɦ ɔ
своїм	s̪ v ɔ j i m
росіяни	r ɔ s̪ i ɑ n̪ ɪ
аби	ɑ b ɪ
її	j i j i
придбати	p r ɪ d̪ b ɑ t̪ ɪ
спеціальний	s̪ p ɛ t̪s̪ʲ i ɑ lʲ n̪ ɪ j
дозвіл	d̪ ɔ z̪ v i l̪
я	j ɑ
можу	m ɔ ʒ u
дивитися	d̪ ɪ v ɪ t̪ ɪ s̪ ɑ
спокійно	s̪ p ɔ k i j n̪ ɔ
хто	x t̪ ɔ
перебував	p ɛ r ɛ b u v ɑ v
борту	b ɔ r t̪ u
загинули	z̪ ɑ ɦ ɪ n̪ u l̪ ɪ
потім	p ɔ t̪ i m
зустрівся	z̪ u s̪ t̪ rʲ i v s̪ ɑ
журналістами	ʒ u r n̪ ɑ lʲ i s̪ t̪ ɑ m ɪ
громадськістю	ɦ r ɔ m ɑ d̪ s̪ k i s̪ t̪ u
обласного	ɔ b l̪ ɑ s̪ n̪ ɔ ɦ ɔ
центру	t̪s̪ ɛ n̪ t̪ r u
дорогу	d̪ ɔ r ɔ ɦ u
грошей	ɦ r ɔ ʃ ɛ j
щоб	ʃ t̪ ʃ ɔ b
втратити	v t̪ r ɑ t̪ ɪ t̪ ɪ
свого	s̪ v ɔ ɦ ɔ
захисту	z̪ ɑ x ɪ s̪ t̪ u
мені	m ɛ n̪ʲ i
дуже	d̪ u ʒ ɛ
подобається	p ɔ d̪ ɔ b ɑ ɛ t̪ s̪ ɑ
таке	t̪ ɑ k ɛ
ще	ʃ t̪ ʃ ɛ
буде	b u d̪ ɛ
є	j ɛ
великі	v ɛ l̪ ɪ k i
підприємства	p i d̪ p r ɪ ɛ m s̪ t̪ v ɑ
нас	n̪ ɑ s̪
геть	ɦ ɛ t̪
інша	i n̪ ʃ ɑ
картина	k ɑ r t̪ ɪ n̪ ɑ
місця	m i s̪ t̪s̪ʲ ɑ
немає	n̪ ɛ m ɑ ɛ
жити	ʒ ɪ t̪ ɪ
Росії	r ɔ s̪ i j i
відкрили	v i d̪ k r ɪ l̪ ɪ
музей	m u z̪ ɛ j
Путіна	p u t̪ i n̪ ɑ
Американські	ɑ m ɛ r ɪ k ɑ n̪ s̪ k i
ЗМІ	z̪ m i
за	z̪ ɑ
кілька	k i lʲ k ɑ
днів	d̪ n̪ʲ i v
сесії	s̪ ɛ s̪ i j i
НУ	n̪ u
поставили	p ɔ s̪ t̪ ɑ v ɪ l̪ ɪ
перед	p ɛ r ɛ d̪
фактом	f ɑ k t̪ ɔ m
була	b u l̪ ɑ
дівчинка	d̪ʲ i v t̪ ʃ ɪ n̪ k ɑ
яку	j ɑ k u
назвали	n̪ ɑ z̪ v ɑ l̪ ɪ
Марія	m ɑ rʲ i ɑ
чому	t̪ ʃ ɔ m u
Олег	ɔ l̪ ɛ ɦ
Блохін	b l̪ ɔ x i n̪
їм	j i m
треба	t̪ r ɛ b ɑ
нашого	n̪ ɑ ʃ ɔ ɦ ɔ
дозволу	d̪ ɔ z̪ v ɔ l̪ u
ціни	t̪s̪ʲ i n̪ ɪ
підняти	p i d̪ n̪ʲ ɑ t̪ ɪ
вересня	v ɛ r ɛ s̪ n̪ʲ ɑ
минулого	m ɪ n̪ u l̪ ɔ ɦ ɔ
року	r ɔ k u
два	d̪ v ɑ
роки	r ɔ k ɪ
поточать	p ɔ t̪ ɔ t̪ ʃ ɑ t̪
деякі	d̪ ɛ ɑ k i
них	n̪ ɪ x
взяли	v z̪ʲ ɑ l̪ ɪ
із	i z̪
собою	s̪ ɔ b ɔ u
дітей	d̪ʲ i t̪ ɛ j
подарунки	p ɔ d̪ ɑ r u n̪ k ɪ
отримали	ɔ t̪ r ɪ m ɑ l̪ ɪ
учасники	u t̪ ʃ ɑ s̪ n̪ ɪ k ɪ
конкурсу	k ɔ n̪ k u r s̪ u
їхні	j i x n̪ʲ i
батьки	b ɑ t̪ k ɪ
таких	t̪ ɑ k ɪ x
звернень	z̪ v ɛ r n̪ ɛ n̪ʲ
п'ять	p j ɑ t̪
йде	j d̪ ɛ
Себастьян	s̪ ɛ b ɑ s̪ t̪ ɑ n̪
Феттель	f ɛ t̪ t̪ ɛ lʲ
знову	z̪ n̪ ɔ v u
переміг	p ɛ r ɛ m i ɦ
поширення	p ɔ ʃ ɪ r ɛ n̪ n̪ʲ ɑ
такі	t̪ ɑ k i
договори	d̪ ɔ ɦ ɔ v ɔ r ɪ
зробив	z̪ r ɔ b ɪ v
себе	s̪ ɛ b ɛ
відкриття	v i d̪ k r ɪ t̪ t̪ ɑ
мою	m ɔ u
думку	d̪ u m k u
їй	j i j
під	p i d̪
будуть	b u d̪ u t̪
тебе	t̪ ɛ b ɛ
ось	ɔ s̪
люди	lʲ u d̪ ɪ
вирішити	v ɪ rʲ i ʃ ɪ t̪ ɪ
разом	r ɑ z̪ ɔ m
видання	v ɪ d̪ ɑ n̪ n̪ʲ ɑ
відчуття	v i d̪ t̪ ʃ u t̪ t̪ ɑ
своєї	s̪ v ɔ ɛ j i
країни	k r ɑ j i n̪ ɪ
день	d̪ ɛ n̪ʲ
мало	m ɑ l̪ ɔ
три	t̪ r ɪ
карбованці	k ɑ r b ɔ v ɑ n̪ t̪s̪ʲ i
заробив	z̪ ɑ r ɔ b ɪ v
тим	t̪ ɪ m
часом	t̪ ʃ ɑ s̪ ɔ m
Вінниці	v i n̪ n̪ ɪ t̪s̪ʲ i
українців	u k r ɑ j i n̪ t̪s̪ʲ i v
борода	b ɔ r ɔ d̪ ɑ
стирчала	s̪ t̪ ɪ r t̪ ʃ ɑ l̪ ɑ
чорна	t̪ ʃ ɔ r n̪ ɑ
матч	m ɑ t̪ t̪ ʃ
відбудеться	v i d̪ b u d̪ ɛ t̪ s̪ ɑ
середу	s̪ ɛ r ɛ d̪ u
третього	t̪ r ɛ t̪ ɔ ɦ ɔ
червня	t̪ ʃ ɛ r v n̪ʲ ɑ
дві	d̪ v i
тисячі	t̪ ɪ s̪ ɑ t̪ ʃ i
тринадцятого	t̪ r ɪ n̪ ɑ d̪ t̪s̪ʲ ɑ t̪ ɔ ɦ ɔ
то	t̪ ɔ
Юля	j u lʲ ɑ
йдеться	j d̪ ɛ t̪ s̪ ɑ
заяві	z̪ ɑ ɑ v i
Нацбанку	n̪ ɑ t̪s̪ b ɑ n̪ k u
донецьких	d̪ ɔ n̪ ɛ t̪s̪ʲ k ɪ x
таки	t̪ ɑ k ɪ
кишені	k ɪ ʃ ɛ n̪ʲ i
тоді	t̪ ɔ d̪ʲ i
потенціал	p ɔ t̪ ɛ n̪ t̪s̪ʲ i ɑ l̪
європейського	j ɛ v r ɔ p ɛ j s̪ k ɔ ɦ ɔ
значно	z̪ n̪ ɑ t̪ ʃ n̪ ɔ
більший	b i lʲ ʃ ɪ j
багато	b ɑ ɦ ɑ t̪ ɔ
доводиться	d̪ ɔ v ɔ d̪ ɪ t̪ s̪ ɑ
робити	r ɔ b ɪ t̪ ɪ
просто	p r ɔ s̪ t̪ ɔ
місці	m i s̪ t̪s̪ʲ i
метою	m ɛ t̪ ɔ u
забезпечення	z̪ ɑ b ɛ z̪ p ɛ t̪ ʃ ɛ n̪ n̪ʲ ɑ
стабільності	s̪ t̪ ɑ b i lʲ n̪ ɔ s̪ t̪ i
держав	d̪ ɛ r ʒ ɑ v
єврозони	j ɛ v r ɔ z̪ ɔ n̪ ɪ
такий	t̪ ɑ k ɪ j
закон	z̪ ɑ k ɔ n̪
діє	d̪ʲ i ɛ
досі	d̪ ɔ s̪ i
краще	k r ɑ ʃ t̪ ʃ ɛ
пізно	p i z̪ n̪ ɔ
ніж	n̪ʲ i ʒ
ніколи	n̪ʲ i k ɔ l̪ ɪ
виглядає	v ɪ ɦ lʲ ɑ d̪ ɑ ɛ
лише	l̪ ɪ ʃ ɛ
початок	p ɔ t̪ ʃ ɑ t̪ ɔ k
серед	s̪ ɛ r ɛ d̪
пріоритетів	p rʲ i ɔ r ɪ t̪ ɛ t̪ i v
облдержадміністрації	ɔ b l̪ d̪ ɛ r ʒ ɑ d̪ m i n̪ʲ i s̪ t̪ r ɑ t̪s̪ʲ i j i
залучення	z̪ ɑ l̪ u t̪ ʃ ɛ n̪ n̪ʲ ɑ
інвестицій	i n̪ v ɛ s̪ t̪ ɪ t̪s̪ʲ i j
крім	k rʲ i m
пенсій	p ɛ n̪ s̪ i j
інших	i n̪ ʃ ɪ x
джерел	d̪ ʒ ɛ r ɛ l̪
доходу	d̪ ɔ x ɔ d̪ u
маємо	m ɑ ɛ m ɔ
взагалі	v z̪ ɑ ɦ ɑ lʲ i
можемо	m ɔ ʒ ɛ m ɔ
залишитися	z̪ ɑ l̪ ɪ ʃ ɪ t̪ ɪ s̪ ɑ
без	b ɛ z̪
хліба	x lʲ i b ɑ
дехто	d̪ ɛ x t̪ ɔ
колег	k ɔ l̪ ɛ ɦ
відверто	v i d̪ v ɛ r t̪ ɔ
говорив	ɦ ɔ v ɔ r ɪ v
цю	t̪s̪ʲ u
проблему	p r ɔ b l̪ ɛ m u
позавчора	p ɔ z̪ ɑ v t̪ ʃ ɔ r ɑ
пролунав	p r ɔ l̪ u n̪ ɑ v
вирок	v ɪ r ɔ k
нове	n̪ ɔ v ɛ
майбутнє	m ɑ j b u t̪ n̪ʲ ɛ
дарує	d̪ ɑ r u ɛ
виборах	v ɪ b ɔ r ɑ x
видно	v ɪ d̪ n̪ ɔ
той	t̪ ɔ j
момент	m ɔ m ɛ n̪ t̪
приміщенні	p r ɪ m i ʃ t̪ ʃ ɛ n̪ n̪ʲ i
вже	v ʒ ɛ
нікого	n̪ʲ i k ɔ ɦ ɔ
має	m ɑ ɛ
бути	b u t̪ ɪ
скільки	s̪ k i lʲ k ɪ
вона	v ɔ n̪ ɑ
потрапила	p ɔ t̪ r ɑ p ɪ l̪ ɑ
звідси	z̪ v i d̪ s̪ ɪ
назва	n̪ ɑ z̪ v ɑ
форуму	f ɔ r u m u
перший	p ɛ r ʃ ɪ j
сайті	s̪ ɑ j t̪ i
міністерства	m i n̪ʲ i s̪ t̪ ɛ r s̪ t̪ v ɑ
оборони	ɔ b ɔ r ɔ n̪ ɪ
через	t̪ ʃ ɛ r ɛ z̪
дні	d̪ n̪ʲ i
повідомлення	p ɔ v i d̪ ɔ m l̪ ɛ n̪ n̪ʲ ɑ
біда	b i d̪ ɑ
всієї	v s̪ i ɛ j i
право	p r ɑ v ɔ
дали	d̪ ɑ l̪ ɪ
живе	ʒ ɪ v ɛ
читачів	t̪ ʃ ɪ t̪ ɑ t̪ ʃ i v
партнерів	p ɑ r t̪ n̪ ɛ rʲ i v
нього	n̪ʲ ɔ ɦ ɔ
вийде	v ɪ j d̪ ɛ
тихо	t̪ ɪ x ɔ
навколо	n̪ ɑ v k ɔ l̪ ɔ
стало	s̪ t̪ ɑ l̪ ɔ
повідомляє	p ɔ v i d̪ ɔ m lʲ ɑ ɛ
сайт	s̪ ɑ j t̪
фонду	f ɔ n̪ d̪ u
якщо	j ɑ k ʃ t̪ ʃ ɔ
страхування	s̪ t̪ r ɑ x u v ɑ n̪ n̪ʲ ɑ
інвалідів	i n̪ v ɑ lʲ i d̪ʲ i v
передбачені	p ɛ r ɛ d̪ b ɑ t̪ ʃ ɛ n̪ʲ i
пільги	p i lʲ ɦ ɪ
хату	x ɑ t̪ u
вимазала	v ɪ m ɑ z̪ ɑ l̪ ɑ
оббілила	ɔ b b i l̪ ɪ l̪ ɑ
Янукович	j ɑ n̪ u k ɔ v ɪ t̪ ʃ
теж	t̪ ɛ ʒ
іде	i d̪ ɛ
цим	t̪s̪ ɪ m
шляхом	ʃ lʲ ɑ x ɔ m
тож	t̪ ɔ ʒ
вирішили	v ɪ rʲ i ʃ ɪ l̪ ɪ
створити	s̪ t̪ v ɔ r ɪ t̪ ɪ
народний	n̪ ɑ r ɔ d̪ n̪ ɪ j
Лесі	l̪ ɛ s̪ i
близькі	b l̪ ɪ z̪ʲ k i
придбання	p r ɪ d̪ b ɑ n̪ n̪ʲ ɑ
активів	ɑ k t̪ ɪ v i v
адже	ɑ d̪ ʒ ɛ
такого	t̪ ɑ k ɔ ɦ ɔ
актор	ɑ k t̪ ɔ r
класу	k l̪ ɑ s̪ u
справді	s̪ p r ɑ v d̪ʲ i
повідомило	p ɔ v i d̪ ɔ m ɪ l̪ ɔ
джерело	d̪ ʒ ɛ r ɛ l̪ ɔ
Української	u k r ɑ j i n̪ s̪ k ɔ j i
правди	p r ɑ v d̪ ɪ
головний	ɦ ɔ l̪ ɔ v n̪ ɪ j
захід	z̪ ɑ x i d̪
Тернопільщині	t̪ ɛ r n̪ ɔ p i lʲ ʃ t̪ ʃ ɪ n̪ʲ i
вийшла	v ɪ j ʃ l̪ ɑ
заміж	z̪ ɑ m i ʒ
народила	n̪ ɑ r ɔ d̪ ɪ l̪ ɑ
вас	v ɑ s̪
політика	p ɔ lʲ i t̪ ɪ k ɑ
інтерес	i n̪ t̪ ɛ r ɛ s̪
робота	r ɔ b ɔ t̪ ɑ
ситуація	s̪ ɪ t̪ u ɑ t̪s̪ʲ i ɑ
сусідній	s̪ u s̪ i d̪ n̪ʲ i j
Польщі	p ɔ lʲ ʃ t̪ ʃ i
нині	n̪ ɪ n̪ʲ i
дещо	d̪ ɛ ʃ t̪ ʃ ɔ
робиться	r ɔ b ɪ t̪ s̪ ɑ
Баварія	b ɑ v ɑ rʲ i ɑ
зацікавилась	z̪ ɑ t̪s̪ʲ i k ɑ v ɪ l̪ ɑ s̪
бразильцем	b r ɑ z̪ ɪ lʲ t̪s̪ ɛ m
київського	k ɪ j i v s̪ k ɔ ɦ ɔ
Динамо	d̪ ɪ n̪ ɑ m ɔ
Франції	f r ɑ n̪ t̪s̪ʲ i j i
працюють	p r ɑ t̪s̪ʲ u u t̪
всю	v s̪ u
потужність	p ɔ t̪ u ʒ n̪ʲ i s̪ t̪
намагаються	n̪ ɑ m ɑ ɦ ɑ u t̪ s̪ ɑ
використати	v ɪ k ɔ r ɪ s̪ t̪ ɑ t̪ ɪ
можливості	m ɔ ʒ l̪ ɪ v ɔ s̪ t̪ i
листопаді	l̪ ɪ s̪ t̪ ɔ p ɑ d̪ʲ i
Тетяна	t̪ ɛ t̪ ɑ n̪ ɑ
знайшла	z̪ n̪ ɑ j ʃ l̪ ɑ
своє	s̪ v ɔ ɛ
щастя	ʃ t̪ ʃ ɑ s̪ t̪ ɑ
свої	s̪ v ɔ j i
проблеми	p r ɔ b l̪ ɛ m ɪ
котрих	k ɔ t̪ r ɪ x
рядок	rʲ ɑ d̪ ɔ k
дрібних	d̪ rʲ i b n̪ ɪ x
перли	p ɛ r l̪ ɪ
зубів	z̪ u b i v
Україні	u k r ɑ j i n̪ʲ i
житті	ʒ ɪ t̪ t̪ i
кожного	k ɔ ʒ n̪ ɔ ɦ ɔ
спортсмена	s̪ p ɔ r t̪ s̪ m ɛ n̪ ɑ
настає	n̪ ɑ s̪ t̪ ɑ ɛ
тому	t̪ ɔ m u
можливість	m ɔ ʒ l̪ ɪ v i s̪ t̪
вибору	v ɪ b ɔ r u
роль	r ɔ lʲ
ДТП	d̪ t̪ p
порушено	p ɔ r u ʃ ɛ n̪ ɔ
кримінальну	k r ɪ m i n̪ ɑ lʲ n̪ u
справу	s̪ p r ɑ v u
готові	ɦ ɔ t̪ ɔ v i
нами	n̪ ɑ m ɪ
бачу	b ɑ t̪ ʃ u
їх	j i x
використовують	v ɪ k ɔ r ɪ s̪ t̪ ɔ v u u t̪
тут	t̪ u t̪
після	p i s̪ lʲ ɑ
здобуття	z̪ d̪ ɔ b u t̪ t̪ ɑ
вищої	v ɪ ʃ t̪ ʃ ɔ j i
освіти	ɔ s̪ v i t̪ ɪ
які	j ɑ k i
розв'язати	r ɔ z̪ v j ɑ z̪ ɑ t̪ ɪ
або	ɑ b ɔ
навчитися	n̪ ɑ v t̪ ʃ ɪ t̪ ɪ s̪ ɑ
ними	n̪ ɪ m ɪ
звичайно	z̪ v ɪ t̪ ʃ ɑ j n̪ ɔ
знали	z̪ n̪ ɑ l̪ ɪ
чекає	t̪ ʃ ɛ k ɑ ɛ
виборча	v ɪ b ɔ r t̪ ʃ ɑ
кампанія	k ɑ m p ɑ n̪ʲ i ɑ
тривала	t̪ r ɪ v ɑ l̪ ɑ
тобто	t̪ ɔ b t̪ ɔ
відповідний	v i d̪ p ɔ v i d̪ n̪ ɪ j
проект	p r ɔ ɛ k t̪
зробить	z̪ r ɔ b ɪ t̪
зацікавлені	z̪ ɑ t̪s̪ʲ i k ɑ v l̪ ɛ n̪ʲ i
одне	ɔ d̪ n̪ ɛ
одному	ɔ d̪ n̪ ɔ m u
подробиці	p ɔ d̪ r ɔ b ɪ t̪s̪ʲ i
наразі	n̪ ɑ r ɑ z̪ʲ i
відомі	v i d̪ ɔ m i
Василь	v ɑ s̪ ɪ lʲ
Шкляр	ʃ k lʲ ɑ r
відповів	v i d̪ p ɔ v i v
наші	n̪ ɑ ʃ i
запитання	z̪ ɑ p ɪ t̪ ɑ n̪ n̪ʲ ɑ
бо	b ɔ
допомагати	d̪ ɔ p ɔ m ɑ ɦ ɑ t̪ ɪ
іншим	i n̪ ʃ ɪ m
яких	j ɑ k ɪ x
Роман	r ɔ m ɑ n̪
Федорів	f ɛ d̪ ɔ rʲ i v
побачити	p ɔ b ɑ t̪ ʃ ɪ t̪ ɪ
місце	m i s̪ t̪s̪ ɛ
аварії	ɑ v ɑ rʲ i j i
власні	v l̪ ɑ s̪ n̪ʲ i
очі	ɔ t̪ ʃ i
білочка	b i l̪ ɔ t̪ ʃ k ɑ
деревину	d̪ ɛ r ɛ v ɪ n̪ u
лісі	lʲ i s̪ i
те	t̪ ɛ
нам	n̪ ɑ m
ніхто	n̪ʲ i x t̪ ɔ
був	b u v
зрозуміти	z̪ r ɔ z̪ u m i t̪ ɪ
представники	p r ɛ d̪ s̪ t̪ ɑ v n̪ ɪ k ɪ
районної	r ɑ j ɔ n̪ n̪ ɔ j i
спільні	s̪ p i lʲ n̪ʲ i
цінності	t̪s̪ʲ i n̪ n̪ ɔ s̪ t̪ i
людські	lʲ u d̪ s̪ k i
виникла	v ɪ n̪ ɪ k l̪ ɑ
проблема	p r ɔ b l̪ ɛ m ɑ
дев'яте	d̪ ɛ v j ɑ t̪ ɛ
двадцята	d̪ v ɑ d̪ t̪s̪ʲ ɑ t̪ ɑ
година	ɦ ɔ d̪ ɪ n̪ ɑ
тридцять	t̪ r ɪ d̪ t̪s̪ʲ ɑ t̪
хвилин	x v ɪ l̪ ɪ n̪
виявила	v ɪ ɑ v ɪ l̪ ɑ
світі	s̪ v i t̪ i
існують	i s̪ n̪ u u t̪
поняття	p ɔ n̪ʲ ɑ t̪ t̪ ɑ
лапок	l̪ ɑ p ɔ k
подібне	p ɔ d̪ʲ i b n̪ ɛ
Україна	u k r ɑ j i n̪ ɑ
велика	v ɛ l̪ ɪ k ɑ
Європейська	j ɛ v r ɔ p ɛ j s̪ k ɑ
держава	d̪ ɛ r ʒ ɑ v ɑ
нашим	n̪ ɑ ʃ ɪ m
людям	lʲ u d̪ʲ ɑ m
потрібно	p ɔ t̪ rʲ i b n̪ ɔ
історія	i s̪ t̪ ɔ rʲ i ɑ
склалася	s̪ k l̪ ɑ l̪ ɑ s̪ ɑ
інакше	i n̪ ɑ k ʃ ɛ
ну	n̪ u
може	m ɔ ʒ ɛ
хоч	x ɔ t̪ ʃ
комусь	k ɔ m u s̪
лежить	l̪ ɛ ʒ ɪ t̪
Януковичем	j ɑ n̪ u k ɔ v ɪ t̪ ʃ ɛ m
утім	u t̪ i m
повне	p ɔ v n̪ ɛ
завершення	z̪ ɑ v ɛ r ʃ ɛ n̪ n̪ʲ ɑ
роботи	r ɔ b ɔ t̪ ɪ
говорити	ɦ ɔ v ɔ r ɪ t̪ ɪ
рано	r ɑ n̪ ɔ
допомогою	d̪ ɔ p ɔ m ɔ ɦ ɔ u
йдуть	j d̪ u t̪
місцевої	m i s̪ t̪s̪ ɛ v ɔ j i
десятого	d̪ ɛ s̪ ɑ t̪ ɔ ɦ ɔ
урізали	u rʲ i z̪ ɑ l̪ ɪ
чимало	t̪ ʃ ɪ m ɑ l̪ ɔ
статей	s̪ t̪ ɑ t̪ ɛ j
витрат	v ɪ t̪ r ɑ t̪
мистецтво	m ɪ s̪ t̪ ɛ t̪s̪ t̪ v ɔ
поліпшення	p ɔ lʲ i p ʃ ɛ n̪ n̪ʲ ɑ
їхнього	j i x n̪ʲ ɔ ɦ ɔ
життя	ʒ ɪ t̪ t̪ ɑ
натомість	n̪ ɑ t̪ ɔ m i s̪ t̪
міська	m i s̪ k ɑ
влада	v l̪ ɑ d̪ ɑ
знав	z̪ n̪ ɑ v
яким	j ɑ k ɪ m
указ	u k ɑ z̪
диво	d̪ ɪ v ɔ
тепло	t̪ ɛ p l̪ ɔ
допомогу	d̪ ɔ p ɔ m ɔ ɦ u
прийшов	p r ɪ j ʃ ɔ v
син	s̪ ɪ n̪
тепер	t̪ ɛ p ɛ r
Закарпатті	z̪ ɑ k ɑ r p ɑ t̪ t̪ i
чотири	t̪ ʃ ɔ t̪ ɪ r ɪ
сотні	s̪ ɔ t̪ n̪ʲ i
тіло	t̪ i l̪ ɔ
знайшли	z̪ n̪ ɑ j ʃ l̪ ɪ
хтось	x t̪ ɔ s̪
передав	p ɛ r ɛ d̪ ɑ v
сказала	s̪ k ɑ z̪ ɑ l̪ ɑ
Мотря	m ɔ t̪ rʲ ɑ
показуючи	p ɔ k ɑ z̪ u u t̪ ʃ ɪ
Карпові	k ɑ r p ɔ v i
перебиту	p ɛ r ɛ b ɪ t̪ u
ногу	n̪ ɔ ɦ u
наскільки	n̪ ɑ s̪ k i lʲ k ɪ
можливо	m ɔ ʒ l̪ ɪ v ɔ
сказати	s̪ k ɑ z̪ ɑ t̪ ɪ
каже	k ɑ ʒ ɛ
повинно	p ɔ v ɪ n̪ n̪ ɔ
чий	t̪ ʃ ɪ j
же	ʒ ɛ
важко	v ɑ ʒ k ɔ
уявити	u ɑ v ɪ t̪ ɪ
можна	m ɔ ʒ n̪ ɑ
такому	t̪ ɑ k ɔ m u
селі	s̪ ɛ lʲ i
негативні	n̪ ɛ ɦ ɑ t̪ ɪ v n̪ʲ i
наслідки	n̪ ɑ s̪ lʲ i d̪ k ɪ
зрештою	z̪ r ɛ ʃ t̪ ɔ u
начальника	n̪ ɑ t̪ ʃ ɑ lʲ n̪ ɪ k ɑ
міліції	m i lʲ i t̪s̪ʲ i j i
належить	n̪ ɑ l̪ ɛ ʒ ɪ t̪
зробити	z̪ r ɔ b ɪ t̪ ɪ
замовлення	z̪ ɑ m ɔ v l̪ ɛ n̪ n̪ʲ ɑ
української	u k r ɑ j i n̪ s̪ k ɔ j i
діаспори	d̪ʲ i ɑ s̪ p ɔ r ɪ
засіданні	z̪ ɑ s̪ i d̪ ɑ n̪ n̪ʲ i
говорили	ɦ ɔ v ɔ r ɪ l̪ ɪ
заборгованість	z̪ ɑ b ɔ r ɦ ɔ v ɑ n̪ʲ i s̪ t̪
заробітної	z̪ ɑ r ɔ b i t̪ n̪ ɔ j i
плати	p l̪ ɑ t̪ ɪ
залишається	z̪ ɑ l̪ ɪ ʃ ɑ ɛ t̪ s̪ ɑ
боротися	b ɔ r ɔ t̪ ɪ s̪ ɑ
зону	z̪ ɔ n̪ u
Ліги	lʲ i ɦ ɪ
чемпіонів	t̪ ʃ ɛ m p i ɔ n̪ʲ i v
зараз	z̪ ɑ r ɑ z̪
такої	t̪ ɑ k ɔ j i
інформації	i n̪ f ɔ r m ɑ t̪s̪ʲ i j i
брали	b r ɑ l̪ ɪ
хотіли	x ɔ t̪ i l̪ ɪ
першим	p ɛ r ʃ ɪ m
працює	p r ɑ t̪s̪ʲ u ɛ
таким	t̪ ɑ k ɪ m
бажання	b ɑ ʒ ɑ n̪ n̪ʲ ɑ
більшості	b i lʲ ʃ ɔ s̪ t̪ i
городян	ɦ ɔ r ɔ d̪ʲ ɑ n̪
депутатів	d̪ ɛ p u t̪ ɑ t̪ i v
міськради	m i s̪ k r ɑ d̪ ɪ
злиття	z̪ l̪ ɪ t̪ t̪ ɑ
російським	r ɔ s̪ i j s̪ k ɪ m
Газпромом	ɦ ɑ z̪ p r ɔ m ɔ m
одна	ɔ d̪ n̪ ɑ
трагедія	t̪ r ɑ ɦ ɛ d̪ʲ i ɑ
Другої	d̪ r u ɦ ɔ j i
світової	s̪ v i t̪ ɔ v ɔ j i
війни	v i j n̪ ɪ
свою	s̪ v ɔ u
чергу	t̪ ʃ ɛ r ɦ u
вимагає	v ɪ m ɑ ɦ ɑ ɛ
куди	k u d̪ ɪ
тонн	t̪ ɔ n̪ n̪
зерна	z̪ ɛ r n̪ ɑ
рамках	r ɑ m k ɑ x
квот	k v ɔ t̪
зоні	z̪ ɔ n̪ʲ i
окупації	ɔ k u p ɑ t̪s̪ʲ i j i
п'ятниця	p j ɑ t̪ n̪ ɪ t̪s̪ʲ ɑ
Алекасндрії	ɑ l̪ ɛ k ɑ s̪ n̪ d̪ rʲ i j i
хвилини	x v ɪ l̪ ɪ n̪ ɪ
другу	d̪ r u ɦ u
якогось	j ɑ k ɔ ɦ ɔ s̪
певного	p ɛ v n̪ ɔ ɦ ɔ
постійного	p ɔ s̪ t̪ i j n̪ ɔ ɦ ɔ
нема	n̪ ɛ m ɑ
чи	t̪ ʃ ɪ
ні	n̪ʲ i
дівчина	d̪ʲ i v t̪ ʃ ɪ n̪ ɑ
перепелка	p ɛ r ɛ p ɛ l̪ k ɑ
знялась	z̪ n̪ʲ ɑ l̪ ɑ s̪
звання	z̪ v ɑ n̪ n̪ʲ ɑ
майстрів	m ɑ j s̪ t̪ rʲ i v
народної	n̪ ɑ r ɔ d̪ n̪ ɔ j i
творчості	t̪ v ɔ r t̪ ʃ ɔ s̪ t̪ i
слід	s̪ lʲ i d̪
довести	d̪ ɔ v ɛ s̪ t̪ ɪ
виявилося	v ɪ ɑ v ɪ l̪ ɔ s̪ ɑ
востаннє	v ɔ s̪ t̪ ɑ n̪ n̪ʲ ɛ
їхати	j i x ɑ t̪ ɪ
затримання	z̪ ɑ t̪ r ɪ m ɑ n̪ n̪ʲ ɑ
показник	p ɔ k ɑ z̪ n̪ ɪ k
залежить	z̪ ɑ l̪ ɛ ʒ ɪ t̪
від	v i d̪
руху	r u x u
товарів	t̪ ɔ v ɑ rʲ i v
послуг	p ɔ s̪ l̪ u ɦ
ваша	v ɑ ʃ ɑ
програма	p r ɔ ɦ r ɑ m ɑ
політичної	p ɔ lʲ i t̪ ɪ t̪ ʃ n̪ ɔ j i
ситуації	s̪ ɪ t̪ u ɑ t̪s̪ʲ i j i
проводиться	p r ɔ v ɔ d̪ ɪ t̪ s̪ ɑ
слідство	s̪ lʲ i d̪ s̪ t̪ v ɔ
всій	v s̪ i j
розмова	r ɔ z̪ m ɔ v ɑ
увірвалася	u v i r v ɑ l̪ ɑ s̪ ɑ
сучасному	s̪ u t̪ ʃ ɑ s̪ n̪ ɔ m u
зокрема	z̪ ɔ k r ɛ m ɑ
безліч	b ɛ z̪ lʲ i t̪ ʃ
газет	ɦ ɑ z̪ ɛ t̪
вирішення	v ɪ rʲ i ʃ ɛ n̪ n̪ʲ ɑ
потребує	p ɔ t̪ r ɛ b u ɛ
багатьох	b ɑ ɦ ɑ t̪ ɔ x
років	r ɔ k i v
самих	s̪ ɑ m ɪ x
цін	t̪s̪ʲ i n̪
здається	z̪ d̪ ɑ ɛ t̪ s̪ ɑ
стратегії	s̪ t̪ r ɑ t̪ ɛ ɦ i j i
йшли	j ʃ l̪ ɪ
мовчки	m ɔ v t̪ ʃ k ɪ
вперед	v p ɛ r ɛ d̪
підписати	p i d̪ p ɪ s̪ ɑ t̪ ɪ
який	j ɑ k ɪ j
здоровий	z̪ d̪ ɔ r ɔ v ɪ j
президент	p r ɛ z̪ ɪ d̪ ɛ n̪ t̪
заступником	z̪ ɑ s̪ t̪ u p n̪ ɪ k ɔ m
негайно	n̪ ɛ ɦ ɑ j n̪ ɔ
виїхав	v ɪ j i x ɑ v
тепла	t̪ ɛ p l̪ ɑ
радіо	r ɑ d̪ʲ i ɔ
Свобода	s̪ v ɔ b ɔ d̪ ɑ
суд	s̪ u d̪
Тимошенко	t̪ ɪ m ɔ ʃ ɛ n̪ k ɔ
Інакше	i n̪ ɑ k ʃ ɛ
мер	m ɛ r
обіцяв	ɔ b i t̪s̪ʲ ɑ v
залишити	z̪ ɑ l̪ ɪ ʃ ɪ t̪ ɪ
посаду	p ɔ s̪ ɑ d̪ u
моїх	m ɔ j i x
кращих	k r ɑ ʃ t̪ ʃ ɪ x
друзів	d̪ r u z̪ʲ i v
одесити	ɔ d̪ ɛ s̪ ɪ t̪ ɪ
доларів	d̪ ɔ l̪ ɑ rʲ i v
групою	ɦ r u p ɔ u
компаній	k ɔ m p ɑ n̪ʲ i j
Газпром	ɦ ɑ z̪ p r ɔ m
університети	u n̪ʲ i v ɛ r s̪ ɪ t̪ ɛ t̪ ɪ
один	ɔ d̪ ɪ n̪
харківський	x ɑ r k i v s̪ k ɪ j
професор	p r ɔ f ɛ s̪ ɔ r
запропонував	z̪ ɑ p r ɔ p ɔ n̪ u v ɑ v
операцію	ɔ p ɛ r ɑ t̪s̪ʲ i u
коаліція	k ɔ ɑ lʲ i t̪s̪ʲ i ɑ
потрібна	p ɔ t̪ rʲ i b n̪ ɑ
створення	s̪ t̪ v ɔ r ɛ n̪ n̪ʲ ɑ
уряду	u rʲ ɑ d̪ u
б	b
знає	z̪ n̪ ɑ ɛ
могло	m ɔ ɦ l̪ ɔ
слова	s̪ l̪ ɔ v ɑ
запросили	z̪ ɑ p r ɔ s̪ ɪ l̪ ɪ
поета	p ɔ ɛ t̪ ɑ
сторони	s̪ t̪ ɔ r ɔ n̪ ɪ
дійшли	d̪ʲ i j ʃ l̪ ɪ
згоди	z̪ ɦ ɔ d̪ ɪ
друга	d̪ r u ɦ ɑ
спільного	s̪ p i lʲ n̪ ɔ ɦ ɔ
фінансування	f i n̪ ɑ n̪ s̪ u v ɑ n̪ n̪ʲ ɑ
проектів	p r ɔ ɛ k t̪ i v
були	b u l̪ ɪ
різні	rʲ i z̪ n̪ʲ i
речі	r ɛ t̪ ʃ i
українці	u k r ɑ j i n̪ t̪s̪ʲ i
довелося	d̪ ɔ v ɛ l̪ ɔ s̪ ɑ
шукати	ʃ u k ɑ t̪ ɪ
починається	p ɔ t̪ ʃ ɪ n̪ ɑ ɛ t̪ s̪ ɑ
революції	r ɛ v ɔ lʲ u t̪s̪ʲ i j i
повернулися	p ɔ v ɛ r n̪ u l̪ ɪ s̪ ɑ
дозволили	d̪ ɔ z̪ v ɔ l̪ ɪ l̪ ɪ
повернутися	p ɔ v ɛ r n̪ u t̪ ɪ s̪ ɑ
користь	k ɔ r ɪ s̪ t̪
перших	p ɛ r ʃ ɪ x
минуло	m ɪ n̪ u l̪ ɔ
певні	p ɛ v n̪ʲ i
зміни	z̪ m i n̪ ɪ
зібралися	z̪ʲ i b r ɑ l̪ ɪ s̪ ɑ
національної	n̪ ɑ t̪s̪ʲ i ɔ n̪ ɑ lʲ n̪ ɔ j i
політики	p ɔ lʲ i t̪ ɪ k ɪ
державного	d̪ ɛ r ʒ ɑ v n̪ ɔ ɦ ɔ
будівництва	b u d̪ʲ i v n̪ ɪ t̪s̪ t̪ v ɑ
імідж	i m i d̪ ʒ
фаворитом	f ɑ v ɔ r ɪ t̪ ɔ m
забігу	z̪ ɑ b i ɦ u
здавалося	z̪ d̪ ɑ v ɑ l̪ ɔ s̪ ɑ
набагато	n̪ ɑ b ɑ ɦ ɑ t̪ ɔ
більше	b i lʲ ʃ ɛ
ви	v ɪ
завоювали	z̪ ɑ v ɔ u v ɑ l̪ ɪ
путівку	p u t̪ i v k u
чемпіонат	t̪ ʃ ɛ m p i ɔ n̪ ɑ t̪
Європи	j ɛ v r ɔ p ɪ
Барселони	b ɑ r s̪ ɛ l̪ ɔ n̪ ɪ
головне	ɦ ɔ l̪ ɔ v n̪ ɛ
завдання	z̪ ɑ v d̪ ɑ n̪ n̪ʲ ɑ
гра	ɦ r ɑ
результат	r ɛ z̪ u lʲ t̪ ɑ t̪
раніше	r ɑ n̪ʲ i ʃ ɛ
вибори	v ɪ b ɔ r ɪ
принаймні	p r ɪ n̪ ɑ j m n̪ʲ i
ясна	j ɑ s̪ n̪ ɑ
річ	rʲ i t̪ ʃ
писати	p ɪ s̪ ɑ t̪ ɪ
найкраще	n̪ ɑ j k r ɑ ʃ t̪ ʃ ɛ
ефективність	ɛ f ɛ k t̪ ɪ v n̪ʲ i s̪ t̪
проекту	p r ɔ ɛ k t̪ u
цифри	t̪s̪ ɪ f r ɪ
факти	f ɑ k t̪ ɪ
потрібні	p ɔ t̪ rʲ i b n̪ʲ i
гроші	ɦ r ɔ ʃ i
минулої	m ɪ n̪ u l̪ ɔ j i
суботи	s̪ u b ɔ t̪ ɪ
нарешті	n̪ ɑ r ɛ ʃ t̪ i
сталося	s̪ t̪ ɑ l̪ ɔ s̪ ɑ
ідея	i d̪ ɛ ɑ
вечора	v ɛ t̪ ʃ ɔ r ɑ
завжди	z̪ ɑ v ʒ d̪ ɪ
вистачає	v ɪ s̪ t̪ ɑ t̪ ʃ ɑ ɛ
любові	lʲ u b ɔ v i
доньки	d̪ ɔ n̪ʲ k ɪ
готова	ɦ ɔ t̪ ɔ v ɑ
водій	v ɔ d̪ʲ i j
втік	v t̪ i k
роботу	r ɔ b ɔ t̪ u
музею	m u z̪ ɛ u
техніки	t̪ ɛ x n̪ʲ i k ɪ
сама	s̪ ɑ m ɑ
проти	p r ɔ t̪ ɪ
місті	m i s̪ t̪ i
справі	s̪ p r ɑ v i
проходить	p r ɔ x ɔ d̪ ɪ t̪
шість	ʃ i s̪ t̪
осіб	ɔ s̪ i b
шукає	ʃ u k ɑ ɛ
одразу	ɔ d̪ r ɑ z̪ u
двох	d̪ v ɔ x
причин	p r ɪ t̪ ʃ ɪ n̪
державне	d̪ ɛ r ʒ ɑ v n̪ ɛ
підприємство	p i d̪ p r ɪ ɛ m s̪ t̪ v ɔ
уже	u ʒ ɛ
викликати	v ɪ k l̪ ɪ k ɑ t̪ ɪ
міліцію	m i lʲ i t̪s̪ʲ i u
самій	s̪ ɑ m i j
межами	m ɛ ʒ ɑ m ɪ
хочуть	x ɔ t̪ ʃ u t̪
зазвичай	z̪ ɑ z̪ v ɪ t̪ ʃ ɑ j
отримувати	ɔ t̪ r ɪ m u v ɑ t̪ ɪ
гостей	ɦ ɔ s̪ t̪ ɛ j
повідомленні	p ɔ v i d̪ ɔ m l̪ ɛ n̪ n̪ʲ i
МНС	m n̪ s̪
рівно	rʲ i v n̪ ɔ
лікарні	lʲ i k ɑ r n̪ʲ i
приїхала	p r ɪ j i x ɑ l̪ ɑ
міліція	m i lʲ i t̪s̪ʲ i ɑ
попередні	p ɔ p ɛ r ɛ d̪ n̪ʲ i
захист	z̪ ɑ x ɪ s̪ t̪
демократії	d̪ ɛ m ɔ k r ɑ t̪ i j i
впровадження	v p r ɔ v ɑ d̪ ʒ ɛ n̪ n̪ʲ ɑ
нової	n̪ ɔ v ɔ j i
системи	s̪ ɪ s̪ t̪ ɛ m ɪ
безпеки	b ɛ z̪ p ɛ k ɪ
харчових	x ɑ r t̪ ʃ ɔ v ɪ x
продуктів	p r ɔ d̪ u k t̪ i v
міг	m i ɦ
захоплення	z̪ ɑ x ɔ p l̪ ɛ n̪ n̪ʲ ɑ
вашу	v ɑ ʃ u
нашу	n̪ ɑ ʃ u
свободу	s̪ v ɔ b ɔ d̪ u
розвитку	r ɔ z̪ v ɪ t̪ k u
перспективи	p ɛ r s̪ p ɛ k t̪ ɪ v ɪ
приблизно	p r ɪ b l̪ ɪ z̪ n̪ ɔ
суму	s̪ u m u
розраховує	r ɔ z̪ r ɑ x ɔ v u ɛ
зібрати	z̪ʲ i b r ɑ t̪ ɪ
країна	k r ɑ j i n̪ ɑ
зробила	z̪ r ɔ b ɪ l̪ ɑ
крок	k r ɔ k
Помаранчевої	p ɔ m ɑ r ɑ n̪ t̪ ʃ ɛ v ɔ j i
пише	p ɪ ʃ ɛ
приводу	p r ɪ v ɔ d̪ u
суддя	s̪ u d̪ d̪ʲ ɑ
відомо	v i d̪ ɔ m ɔ
малого	m ɑ l̪ ɔ ɦ ɔ
перемогла	p ɛ r ɛ m ɔ ɦ l̪ ɑ
завтра	z̪ ɑ v t̪ r ɑ
виграє	v ɪ ɦ r ɑ ɛ
інший	i n̪ ʃ ɪ j
хіба	x i b ɑ
сіл	s̪ i l̪
батько	b ɑ t̪ k ɔ
проте	p r ɔ t̪ ɛ
проблем	p r ɔ b l̪ ɛ m
де	d̪ ɛ
взяти	v z̪ʲ ɑ t̪ ɪ
ці	t̪s̪ʲ i
важливо	v ɑ ʒ l̪ ɪ v ɔ
викликав	v ɪ k l̪ ɪ k ɑ v
кожен	k ɔ ʒ ɛ n̪
визначає	v ɪ z̪ n̪ ɑ t̪ ʃ ɑ ɛ
вибрати	v ɪ b r ɑ t̪ ɪ
причому	p r ɪ t̪ ʃ ɔ m u
трьох	t̪ rʲ ɔ x
зможемо	z̪ m ɔ ʒ ɛ m ɔ
платити	p l̪ ɑ t̪ ɪ t̪ ɪ
написано	n̪ ɑ p ɪ s̪ ɑ n̪ ɔ
чиновники	t̪ ʃ ɪ n̪ ɔ v n̪ ɪ k ɪ
ставлять	s̪ t̪ ɑ v lʲ ɑ t̪
кажуть	k ɑ ʒ u t̪
політику	p ɔ lʲ i t̪ ɪ k u
само	s̪ ɑ m ɔ
школи	ʃ k ɔ l̪ ɪ
усі	u s̪ i
ресурси	r ɛ s̪ u r s̪ ɪ
потребують	p ɔ t̪ r ɛ b u u t̪
коштів	k ɔ ʃ t̪ i v
окрім	ɔ k rʲ i m
організації	ɔ r ɦ ɑ n̪ʲ i z̪ ɑ t̪s̪ʲ i j i
результати	r ɛ z̪ u lʲ t̪ ɑ t̪ ɪ
тижня	t̪ ɪ ʒ n̪ʲ ɑ
стосунків	s̪ t̪ ɔ s̪ u n̪ k i v
ЄС	j ɛ s̪
надвечір	n̪ ɑ d̪ v ɛ t̪ ʃ i r
розпрощались	r ɔ z̪ p r ɔ ʃ t̪ ʃ ɑ l̪ ɪ s̪
новими	n̪ ɔ v ɪ m ɪ
сватами	s̪ v ɑ t̪ ɑ m ɪ
поїхали	p ɔ j i x ɑ l̪ ɪ
додому	d̪ ɔ d̪ ɔ m u
шпазі	ʃ p ɑ z̪ʲ i
українок	u k r ɑ j i n̪ ɔ k
залишилася	z̪ ɑ l̪ ɪ ʃ ɪ l̪ ɑ s̪ ɑ
спортсменка	s̪ p ɔ r t̪ s̪ m ɛ n̪ k ɑ
листі	l̪ ɪ s̪ t̪ i
сімей	s̪ i m ɛ j
постраждалих	p ɔ s̪ t̪ r ɑ ʒ d̪ ɑ l̪ ɪ x
зазначив	z̪ ɑ z̪ n̪ ɑ t̪ ʃ ɪ v
виявили	v ɪ ɑ v ɪ l̪ ɪ
семеро	s̪ ɛ m ɛ r ɔ
компанією	k ɔ m p ɑ n̪ʲ i ɛ u
RosUkrEnergo	r ɔ s̪ u k r ɛ n̪ ɛ r ɡ ɔ
володіє	v ɔ l̪ ɔ d̪ʲ i ɛ
бізнесмен	b i z̪ n̪ ɛ s̪ m ɛ n̪
Дмитро	d̪ m ɪ t̪ r ɔ
Фірташ	f i r t̪ ɑ ʃ
частка	t̪ ʃ ɑ s̪ t̪ k ɑ
типу	t̪ ɪ p u
поступово	p ɔ s̪ t̪ u p ɔ v ɔ
зростає	z̪ r ɔ s̪ t̪ ɑ ɛ
відміну	v i d̪ m i n̪ u
нинішніх	n̪ ɪ n̪ʲ i ʃ n̪ʲ i x
наукових	n̪ ɑ u k ɔ v ɪ x
авторів	ɑ v t̪ ɔ rʲ i v
економічна	ɛ k ɔ n̪ ɔ m i t̪ ʃ n̪ ɑ
правда	p r ɑ v d̪ ɑ
мій	m i j
погляд	p ɔ ɦ lʲ ɑ d̪
погано	p ɔ ɦ ɑ n̪ ɔ
Кучми	k u t̪ ʃ m ɪ
Катерина	k ɑ t̪ ɛ r ɪ n̪ ɑ
душі	d̪ u ʃ i
чула	t̪ ʃ u l̪ ɑ
ньому	n̪ʲ ɔ m u
своєму	s̪ v ɔ ɛ m u
коментарі	k ɔ m ɛ n̪ t̪ ɑ rʲ i
повинні	p ɔ v ɪ n̪ n̪ʲ i
повернути	p ɔ v ɛ r n̪ u t̪ ɪ
бюджет	b u d̪ ʒ ɛ t̪
кризу	k r ɪ z̪ u
довго	d̪ ɔ v ɦ ɔ
продовження	p r ɔ d̪ ɔ v ʒ ɛ n̪ n̪ʲ ɑ
відповідальності	v i d̪ p ɔ v i d̪ ɑ lʲ n̪ ɔ s̪ t̪ i
джерела	d̪ ʒ ɛ r ɛ l̪ ɑ
усе	u s̪ ɛ
насправді	n̪ ɑ s̪ p r ɑ v d̪ʲ i
почалося	p ɔ t̪ ʃ ɑ l̪ ɔ s̪ ɑ
пішов	p i ʃ ɔ v
п'ятий	p j ɑ t̪ ɪ j
десяток	d̪ ɛ s̪ ɑ t̪ ɔ k
голова	ɦ ɔ l̪ ɔ v ɑ
версію	v ɛ r s̪ i u
обласному	ɔ b l̪ ɑ s̪ n̪ ɔ m u
центрі	t̪s̪ ɛ n̪ t̪ rʲ i
Прикарпаття	p r ɪ k ɑ r p ɑ t̪ t̪ ɑ
мешкає	m ɛ ʃ k ɑ ɛ
майже	m ɑ j ʒ ɛ
десятиліття	d̪ ɛ s̪ ɑ t̪ ɪ lʲ i t̪ t̪ ɑ
випадках	v ɪ p ɑ d̪ k ɑ x
важливим	v ɑ ʒ l̪ ɪ v ɪ m
громадянського	ɦ r ɔ m ɑ d̪ʲ ɑ n̪ s̪ k ɔ ɦ ɔ
суспільства	s̪ u s̪ p i lʲ s̪ t̪ v ɑ
головою	ɦ ɔ l̪ ɔ v ɔ u
саме	s̪ ɑ m ɛ
ціну	t̪s̪ʲ i n̪ u
газ	ɦ ɑ z̪
буду	b u d̪ u
представників	p r ɛ d̪ s̪ t̪ ɑ v n̪ ɪ k i v
гарний	ɦ ɑ r n̪ ɪ j
приклад	p r ɪ k l̪ ɑ d̪
обласних	ɔ b l̪ ɑ s̪ n̪ ɪ x
міських	m i s̪ k ɪ x
видань	v ɪ d̪ ɑ n̪ʲ
разу	r ɑ z̪ u
світу	s̪ v i t̪ u
справедливість	s̪ p r ɑ v ɛ d̪ l̪ ɪ v i s̪ t̪
нашій	n̪ ɑ ʃ i j
ставиться	s̪ t̪ ɑ v ɪ t̪ s̪ ɑ
необхідно	n̪ ɛ ɔ b x i d̪ n̪ ɔ
відкрити	v i d̪ k r ɪ t̪ ɪ
рахунок	r ɑ x u n̪ ɔ k
отримання	ɔ t̪ r ɪ m ɑ n̪ n̪ʲ ɑ
винен	v ɪ n̪ ɛ n̪
щонайменше	ʃ t̪ ʃ ɔ n̪ ɑ j m ɛ n̪ ʃ ɛ
піде	p i d̪ ɛ
рішення	rʲ i ʃ ɛ n̪ n̪ʲ ɑ
Президент	p r ɛ z̪ ɪ d̪ ɛ n̪ t̪
пообіцяв	p ɔ ɔ b i t̪s̪ʲ ɑ v
наступного	n̪ ɑ s̪ t̪ u p n̪ ɔ ɦ ɔ
останній	ɔ s̪ t̪ ɑ n̪ n̪ʲ i j
весни	v ɛ s̪ n̪ ɪ
зробили	z̪ r ɔ b ɪ l̪ ɪ
змогли	z̪ m ɔ ɦ l̪ ɪ
форми	f ɔ r m ɪ
поет	p ɔ ɛ t̪
художник	x u d̪ ɔ ʒ n̪ ɪ k
творити	t̪ v ɔ r ɪ t̪ ɪ
хочу	x ɔ t̪ ʃ u
інше	i n̪ ʃ ɛ
театр	t̪ ɛ ɑ t̪ r
збирається	z̪ b ɪ r ɑ ɛ t̪ s̪ ɑ
йти	j t̪ ɪ
Черкаської	t̪ ʃ ɛ r k ɑ s̪ k ɔ j i
добрий	d̪ ɔ b r ɪ j
центральному	t̪s̪ ɛ n̪ t̪ r ɑ lʲ n̪ ɔ m u
рівні	rʲ i v n̪ʲ i
дороги	d̪ ɔ r ɔ ɦ ɪ
пояснює	p ɔ ɑ s̪ n̪ʲ u ɛ
місяці	m i s̪ ɑ t̪s̪ʲ i
неї	n̪ ɛ j i
письменники	p ɪ s̪ m ɛ n̪ n̪ ɪ k ɪ
написали	n̪ ɑ p ɪ s̪ ɑ l̪ ɪ
несе	n̪ ɛ s̪ ɛ
народ	n̪ ɑ r ɔ d̪
єдиного	j ɛ d̪ ɪ n̪ ɔ ɦ ɔ
бачення	b ɑ t̪ ʃ ɛ n̪ n̪ʲ ɑ
історії	i s̪ t̪ ɔ rʲ i j i
торгівлі	t̪ ɔ r ɦ i v lʲ i
НБУ	n̪ b u
Мінфін	m i n̪ f i n̪
пообіцяли	p ɔ ɔ b i t̪s̪ʲ ɑ l̪ ɪ
сприяти	s̪ p r ɪ ɑ t̪ ɪ
вибух	v ɪ b u x
березні	b ɛ r ɛ z̪ n̪ʲ i
обійшлося	ɔ b i j ʃ l̪ ɔ s̪ ɑ
жертв	ʒ ɛ r t̪ v
жінці	ʒ i n̪ t̪s̪ʲ i
стільки	s̪ t̪ i lʲ k ɪ
тіл	t̪ i l̪
знайдено	z̪ n̪ ɑ j d̪ ɛ n̪ ɔ
твори	t̪ v ɔ r ɪ
подібні	p ɔ d̪ʲ i b n̪ʲ i
університет	u n̪ʲ i v ɛ r s̪ ɪ t̪ ɛ t̪
мати	m ɑ t̪ ɪ
особливості	ɔ s̪ ɔ b l̪ ɪ v ɔ s̪ t̪ i
свій	s̪ v i j
характер	x ɑ r ɑ k t̪ ɛ r
справа	s̪ p r ɑ v ɑ
інцидент	i n̪ t̪s̪ ɪ d̪ ɛ n̪ t̪
міжнародний	m i ʒ n̪ ɑ r ɔ d̪ n̪ ɪ j
скандал	s̪ k ɑ n̪ d̪ ɑ l̪
далеко	d̪ ɑ l̪ ɛ k ɔ
райцентру	r ɑ j t̪s̪ ɛ n̪ t̪ r u
головна	ɦ ɔ l̪ ɔ v n̪ ɑ
тема	t̪ ɛ m ɑ
звісно	z̪ v i s̪ n̪ ɔ
Різдво	rʲ i z̪ d̪ v ɔ
точно	t̪ ɔ t̪ ʃ n̪ ɔ
знаю	z̪ n̪ ɑ u
території	t̪ ɛ r ɪ t̪ ɔ rʲ i j i
зустріч	z̪ u s̪ t̪ rʲ i t̪ ʃ
Президентом	p r ɛ z̪ ɪ d̪ ɛ n̪ t̪ ɔ m
початку	p ɔ t̪ ʃ ɑ t̪ k u
кінця	k i n̪ t̪s̪ʲ ɑ
ним	n̪ ɪ m
знаходився	z̪ n̪ ɑ x ɔ d̪ ɪ v s̪ ɑ
робітників	r ɔ b i t̪ n̪ ɪ k i v
вулиці	v u l̪ ɪ t̪s̪ʲ i
нею	n̪ ɛ u
стала	s̪ t̪ ɑ l̪ ɑ
додати	d̪ ɔ d̪ ɑ t̪ ɪ
обіцяє	ɔ b i t̪s̪ʲ ɑ ɛ
звернутися	z̪ v ɛ r n̪ u t̪ ɪ s̪ ɑ
суду	s̪ u d̪ u
частина	t̪ ʃ ɑ s̪ t̪ ɪ n̪ ɑ
активно	ɑ k t̪ ɪ v n̪ ɔ
ній	n̪ʲ i j
щось	ʃ t̪ ʃ ɔ s̪
стояла	s̪ t̪ ɔ ɑ l̪ ɑ
ведеться	v ɛ d̪ ɛ t̪ s̪ ɑ
дня	d̪ n̪ʲ ɑ
мав	m ɑ v
вийти	v ɪ j t̪ ɪ
кадри	k ɑ d̪ r ɪ
готувати	ɦ ɔ t̪ u v ɑ t̪ ɪ
армії	ɑ r m i j i
стоїть	s̪ t̪ ɔ j i t̪
символ	s̪ ɪ m v ɔ l̪
присутності	p r ɪ s̪ u t̪ n̪ ɔ s̪ t̪ i
нові	n̪ ɔ v i
іноді	i n̪ ɔ d̪ʲ i
приходять	p r ɪ x ɔ d̪ʲ ɑ t̪
старі	s̪ t̪ ɑ rʲ i
лежав	l̪ ɛ ʒ ɑ v
печі	p ɛ t̪ ʃ i
веретена	v ɛ r ɛ t̪ ɛ n̪ ɑ
сюрчать	s̪ u r t̪ ʃ ɑ t̪
бік	b i k
навчання	n̪ ɑ v t̪ ʃ ɑ n̪ n̪ʲ ɑ
беруть	b ɛ r u t̪
шукаю	ʃ u k ɑ u
іншу	i n̪ ʃ u
стежку	s̪ t̪ ɛ ʒ k u
дев'ятнадцяте	d̪ ɛ v j ɑ t̪ n̪ ɑ d̪ t̪s̪ʲ ɑ t̪ ɛ
липня	l̪ ɪ p n̪ʲ ɑ
Житомиру	ʒ ɪ t̪ ɔ m ɪ r u
сьома	s̪ ɔ m ɑ
велике	v ɛ l̪ ɪ k ɛ
усім	u s̪ i m
права	p r ɑ v ɑ
людини	lʲ u d̪ ɪ n̪ ɪ
горах	ɦ ɔ r ɑ x
знають	z̪ n̪ ɑ u t̪
великого	v ɛ l̪ ɪ k ɔ ɦ ɔ
Новий	n̪ ɔ v ɪ j
рік	rʲ i k
зустріли	z̪ u s̪ t̪ rʲ i l̪ ɪ
цьому	t̪s̪ʲ ɔ m u
кабінеті	k ɑ b i n̪ ɛ t̪ i
практиці	p r ɑ k t̪ ɪ t̪s̪ʲ i
воду	v ɔ d̪ u
отримує	ɔ t̪ r ɪ m u ɛ
третина	t̪ r ɛ t̪ ɪ n̪ ɑ
чого	t̪ ʃ ɔ ɦ ɔ
найкращий	n̪ ɑ j k r ɑ ʃ t̪ ʃ ɪ j
даний	d̪ ɑ n̪ ɪ j
державні	d̪ ɛ r ʒ ɑ v n̪ʲ i
російською	r ɔ s̪ i j s̪ k ɔ u
мовою	m ɔ v ɔ u
батьків	b ɑ t̪ k i v
різних	rʲ i z̪ n̪ ɪ x
думок	d̪ u m ɔ k
ідей	i d̪ ɛ j
повернувся	p ɔ v ɛ r n̪ u v s̪ ɑ
робили	r ɔ b ɪ l̪ ɪ
така	t̪ ɑ k ɑ
ходить	x ɔ d̪ ɪ t̪
бувало	b u v ɑ l̪ ɔ
восени	v ɔ s̪ ɛ n̪ ɪ
зимою	z̪ ɪ m ɔ u
двору	d̪ v ɔ r u
принципу	p r ɪ n̪ t̪s̪ ɪ p u
понад	p ɔ n̪ ɑ d̪
кримінальних	k r ɪ m i n̪ ɑ lʲ n̪ ɪ x
справ	s̪ p r ɑ v
мали	m ɑ l̪ ɪ
законом	z̪ ɑ k ɔ n̪ ɔ m
виставку	v ɪ s̪ t̪ ɑ v k u
Києві	k ɪ ɛ v i
іншого	i n̪ ʃ ɔ ɦ ɔ
водночас	v ɔ d̪ n̪ ɔ t̪ ʃ ɑ s̪
мала	m ɑ l̪ ɑ
бойових	b ɔ j ɔ v ɪ x
дій	d̪ʲ i j
молила	m ɔ l̪ ɪ l̪ ɑ
кращі	k r ɑ ʃ t̪ ʃ i
похваливсь	p ɔ x v ɑ l̪ ɪ v s̪
рішенням	rʲ i ʃ ɛ n̪ n̪ʲ ɑ m
хлопця	x l̪ ɔ p t̪s̪ʲ ɑ
сюди	s̪ u d̪ ɪ
влаштували	v l̪ ɑ ʃ t̪ u v ɑ l̪ ɪ
значення	z̪ n̪ ɑ t̪ ʃ ɛ n̪ n̪ʲ ɑ
доручив	d̪ ɔ r u t̪ ʃ ɪ v
розробити	r ɔ z̪ r ɔ b ɪ t̪ ɪ
надати	n̪ ɑ d̪ ɑ t̪ ɪ
план	p l̪ ɑ n̪
землю	z̪ ɛ m lʲ u
підуть	p i d̪ u t̪
буває	b u v ɑ ɛ
тисяч	t̪ ɪ s̪ ɑ t̪ ʃ
таку	t̪ ɑ k u
змогу	z̪ m ɔ ɦ u
дає	d̪ ɑ ɛ
ця	t̪s̪ʲ ɑ
книжка	k n̪ ɪ ʒ k ɑ
вдається	v d̪ ɑ ɛ t̪ s̪ ɑ
зумів	z̪ u m i v
подав	p ɔ d̪ ɑ v
одночасно	ɔ d̪ n̪ ɔ t̪ ʃ ɑ s̪ n̪ ɔ
процес	p r ɔ t̪s̪ ɛ s̪
триває	t̪ r ɪ v ɑ ɛ
декілька	d̪ ɛ k i lʲ k ɑ
морозива	m ɔ r ɔ z̪ ɪ v ɑ
пива	p ɪ v ɑ
води	v ɔ d̪ ɪ
от	ɔ t̪
тему	t̪ ɛ m u
Микола	m ɪ k ɔ l̪ ɑ
Азаров	ɑ z̪ ɑ r ɔ v
надзвичайно	n̪ ɑ d̪ z̪ v ɪ t̪ ʃ ɑ j n̪ ɔ
важливий	v ɑ ʒ l̪ ɪ v ɪ j
розповідає	r ɔ z̪ p ɔ v i d̪ ɑ ɛ
починають	p ɔ t̪ ʃ ɪ n̪ ɑ u t̪
взялися	v z̪ʲ ɑ l̪ ɪ s̪ ɑ
розказував	r ɔ z̪ k ɑ z̪ u v ɑ v
одказала	ɔ d̪ k ɑ z̪ ɑ l̪ ɑ
ясне	j ɑ s̪ n̪ ɛ
сонце	s̪ ɔ n̪ t̪s̪ ɛ
тепле	t̪ ɛ p l̪ ɛ
приязне	p r ɪ ɑ z̪ n̪ ɛ
погодився	p ɔ ɦ ɔ d̪ ɪ v s̪ ɑ
січні	s̪ i t̪ ʃ n̪ʲ i
наприкінці	n̪ ɑ p r ɪ k i n̪ t̪s̪ʲ i
грудня	ɦ r u d̪ n̪ʲ ɑ
отець	ɔ t̪ ɛ t̪s̪ʲ
ті	t̪ i
живуть	ʒ ɪ v u t̪
республиці	r ɛ s̪ p u b l̪ ɪ t̪s̪ʲ i
Чад	t̪ ʃ ɑ d̪
колишній	k ɔ l̪ ɪ ʃ n̪ʲ i j
начальник	n̪ ɑ t̪ ʃ ɑ lʲ n̪ ɪ k
прізвище	p rʲ i z̪ v ɪ ʃ t̪ ʃ ɛ
відбувалося	v i d̪ b u v ɑ l̪ ɔ s̪ ɑ
участі	u t̪ ʃ ɑ s̪ t̪ i
чиновників	t̪ ʃ ɪ n̪ ɔ v n̪ ɪ k i v
глянь	ɦ lʲ ɑ n̪ʲ
скрізь	s̪ k rʲ i z̪ʲ
розвернулося	r ɔ z̪ v ɛ r n̪ u l̪ ɔ s̪ ɑ
розпустилося	r ɔ z̪ p u s̪ t̪ ɪ l̪ ɔ s̪ ɑ
зацвіло	z̪ ɑ t̪s̪ v i l̪ ɔ
пишним	p ɪ ʃ n̪ ɪ m
цвітом	t̪s̪ v i t̪ ɔ m
здивувавшись	z̪ d̪ ɪ v u v ɑ v ʃ ɪ s̪
питанню	p ɪ t̪ ɑ n̪ n̪ʲ u
ти	t̪ ɪ
законодавства	z̪ ɑ k ɔ n̪ ɔ d̪ ɑ v s̪ t̪ v ɑ
інфраструктури	i n̪ f r ɑ s̪ t̪ r u k t̪ u r ɪ
Українській	u k r ɑ j i n̪ s̪ k i j
правді	p r ɑ v d̪ʲ i
якраз	j ɑ k r ɑ z̪
молоді	m ɔ l̪ ɔ d̪ʲ i
наше	n̪ ɑ ʃ ɛ
новій	n̪ ɔ v i j
якості	j ɑ k ɔ s̪ t̪ i
іншою	i n̪ ʃ ɔ u
гривень	ɦ r ɪ v ɛ n̪ʲ
випуску	v ɪ p u s̪ k u
облігацій	ɔ b lʲ i ɦ ɑ t̪s̪ʲ i j
ОВДП	ɔ v d̪ p
жінка	ʒ i n̪ k ɑ
одгадувала	ɔ d̪ ɦ ɑ d̪ u v ɑ l̪ ɑ
напасть	n̪ ɑ p ɑ s̪ t̪
воно	v ɔ n̪ ɔ
міста	m i s̪ t̪ ɑ
вирішила	v ɪ rʲ i ʃ ɪ l̪ ɑ
передати	p ɛ r ɛ d̪ ɑ t̪ ɪ
приміщення	p r ɪ m i ʃ t̪ ʃ ɛ n̪ n̪ʲ ɑ
дітям	d̪ʲ i t̪ ɑ m
отримав	ɔ t̪ r ɪ m ɑ v
назву	n̪ ɑ z̪ v u
війна	v i j n̪ ɑ
пам'яті	p ɑ m j ɑ t̪ i
би	b ɪ
погляду	p ɔ ɦ lʲ ɑ d̪ u
законів	z̪ ɑ k ɔ n̪ʲ i v
держави	d̪ ɛ r ʒ ɑ v ɪ
порядок	p ɔ rʲ ɑ d̪ ɔ k
кожна	k ɔ ʒ n̪ ɑ
веде	v ɛ d̪ ɛ
гру	ɦ r u
учасників	u t̪ ʃ ɑ s̪ n̪ ɪ k i v
журналістів	ʒ u r n̪ ɑ lʲ i s̪ t̪ i v
наш	n̪ ɑ ʃ
цілком	t̪s̪ʲ i l̪ k ɔ m
відтоді	v i d̪ t̪ ɔ d̪ʲ i
борг	b ɔ r ɦ
результаті	r ɛ z̪ u lʲ t̪ ɑ t̪ i
вийшло	v ɪ j ʃ l̪ ɔ
сталася	s̪ t̪ ɑ l̪ ɑ s̪ ɑ
важлива	v ɑ ʒ l̪ ɪ v ɑ
подія	p ɔ d̪ʲ i ɑ
дійсно	d̪ʲ i j s̪ n̪ ɔ
привід	p r ɪ v i d̪
акцію	ɑ k t̪s̪ʲ i u
служба	s̪ l̪ u ʒ b ɑ
справах	s̪ p r ɑ v ɑ x
проводить	p r ɔ v ɔ d̪ ɪ t̪
щороку	ʃ t̪ ʃ ɔ r ɔ k u
користуватися	k ɔ r ɪ s̪ t̪ u v ɑ t̪ ɪ s̪ ɑ
земля	z̪ ɛ m lʲ ɑ
бачити	b ɑ t̪ ʃ ɪ t̪ ɪ
забули	z̪ ɑ b u l̪ ɪ
останні	ɔ s̪ t̪ ɑ n̪ n̪ʲ i
гри	ɦ r ɪ
Табачник	t̪ ɑ b ɑ t̪ ʃ n̪ ɪ k
морального	m ɔ r ɑ lʲ n̪ ɔ ɦ ɔ
членом	t̪ ʃ l̪ ɛ n̪ ɔ m
українського	u k r ɑ j i n̪ s̪ k ɔ ɦ ɔ
побачив	p ɔ b ɑ t̪ ʃ ɪ v
фахівців	f ɑ x i v t̪s̪ʲ i v
вивчення	v ɪ v t̪ ʃ ɛ n̪ n̪ʲ ɑ
становить	s̪ t̪ ɑ n̪ ɔ v ɪ t̪
величезний	v ɛ l̪ ɪ t̪ ʃ ɛ z̪ n̪ ɪ j
реформу	r ɛ f ɔ r m u
роблять	r ɔ b lʲ ɑ t̪
журба	ʒ u r b ɑ
невимовна	n̪ ɛ v ɪ m ɔ v n̪ ɑ
гнітити	ɦ n̪ʲ i t̪ ɪ t̪ ɪ
душу	d̪ u ʃ u
серце	s̪ ɛ r t̪s̪ ɛ
заради	z̪ ɑ r ɑ d̪ ɪ
ставили	s̪ t̪ ɑ v ɪ l̪ ɪ
змагань	z̪ m ɑ ɦ ɑ n̪ʲ
всіх	v s̪ i x
думала	d̪ u m ɑ l̪ ɑ
якусь	j ɑ k u s̪
тяжку	t̪ ɑ ʒ k u
майбутньому	m ɑ j b u t̪ n̪ʲ ɔ m u
побудувати	p ɔ b u d̪ u v ɑ t̪ ɪ
Росію	r ɔ s̪ i u
Європі	j ɛ v r ɔ p i
прийде	p r ɪ j d̪ ɛ
моменту	m ɔ m ɛ n̪ t̪ u
бачили	b ɑ t̪ ʃ ɪ l̪ ɪ
кошти	k ɔ ʃ t̪ ɪ
сьомою	s̪ ɔ m ɔ u
економіки	ɛ k ɔ n̪ ɔ m i k ɪ
відродження	v i d̪ r ɔ d̪ ʒ ɛ n̪ n̪ʲ ɑ
рази	r ɑ z̪ ɪ
двадцяте	d̪ v ɑ d̪ t̪s̪ʲ ɑ t̪ ɛ
серпня	s̪ ɛ r p n̪ʲ ɑ
Полтаві	p ɔ l̪ t̪ ɑ v i
восьма	v ɔ s̪ m ɑ
сорок	s̪ ɔ r ɔ k
наближаємось	n̪ ɑ b l̪ ɪ ʒ ɑ ɛ m ɔ s̪
мети	m ɛ t̪ ɪ
десятки	d̪ ɛ s̪ ɑ t̪ k ɪ
мільйонів	m i lʲ j ɔ n̪ʲ i v
Полтавщині	p ɔ l̪ t̪ ɑ v ʃ t̪ ʃ ɪ n̪ʲ i
очікують	ɔ t̪ ʃ i k u u t̪
врожай	v r ɔ ʒ ɑ j
відбувається	v i d̪ b u v ɑ ɛ t̪ s̪ ɑ
допоміг	d̪ ɔ p ɔ m i ɦ
зуміли	z̪ u m i l̪ ɪ
журналістам	ʒ u r n̪ ɑ lʲ i s̪ t̪ ɑ m
повідомила	p ɔ v i d̪ ɔ m ɪ l̪ ɑ
Юлія	j u lʲ i ɑ
честь	t̪ ʃ ɛ s̪ t̪
чути	t̪ ʃ u t̪ ɪ
рідну	rʲ i d̪ n̪ u
людину	lʲ u d̪ ɪ n̪ u
одній	ɔ d̪ n̪ʲ i j
землі	z̪ ɛ m lʲ i
українській	u k r ɑ j i n̪ s̪ k i j
пішли	p i ʃ l̪ ɪ
чоловіки	t̪ ʃ ɔ l̪ ɔ v i k ɪ
загрожує	z̪ ɑ ɦ r ɔ ʒ u ɛ
штраф	ʃ t̪ r ɑ f
арешт	ɑ r ɛ ʃ t̪
збудувати	z̪ b u d̪ u v ɑ t̪ ɪ
храм	x r ɑ m
рейтинг	r ɛ j t̪ ɪ n̪ ɦ
найбагатших	n̪ ɑ j b ɑ ɦ ɑ t̪ ʃ ɪ x
заявила	z̪ ɑ ɑ v ɪ l̪ ɑ
дружина	d̪ r u ʒ ɪ n̪ ɑ
Луценка	l̪ u t̪s̪ ɛ n̪ k ɑ
Ірина	i r ɪ n̪ ɑ
узяв	u z̪ʲ ɑ v
кількох	k i lʲ k ɔ x
своїх	s̪ v ɔ j i x
учнів	u t̪ ʃ n̪ʲ i v
епоха	ɛ p ɔ x ɑ
літератури	lʲ i t̪ ɛ r ɑ t̪ u r ɪ
МВС	m v s̪
чомусь	t̪ ʃ ɔ m u s̪
приїхав	p r ɪ j i x ɑ v
попросили	p ɔ p r ɔ s̪ ɪ l̪ ɪ
існування	i s̪ n̪ u v ɑ n̪ n̪ʲ ɑ
секти	s̪ ɛ k t̪ ɪ
найкращі	n̪ ɑ j k r ɑ ʃ t̪ ʃ i
пропозиції	p r ɔ p ɔ z̪ ɪ t̪s̪ʲ i j i
встановлено	v s̪ t̪ ɑ n̪ ɔ v l̪ ɛ n̪ ɔ
премії	p r ɛ m i j i
скоротити	s̪ k ɔ r ɔ t̪ ɪ t̪ ɪ
споживання	s̪ p ɔ ʒ ɪ v ɑ n̪ n̪ʲ ɑ
збільшити	z̪ b i lʲ ʃ ɪ t̪ ɪ
виробництво	v ɪ r ɔ b n̪ ɪ t̪s̪ t̪ v ɔ
одним	ɔ d̪ n̪ ɪ m
найбільших	n̪ ɑ j b i lʲ ʃ ɪ x
євро	j ɛ v r ɔ
місто	m i s̪ t̪ ɔ
отримає	ɔ t̪ r ɪ m ɑ ɛ
травні	t̪ r ɑ v n̪ʲ i
хочемо	x ɔ t̪ ʃ ɛ m ɔ
імперія	i m p ɛ rʲ i ɑ
створена	s̪ t̪ v ɔ r ɛ n̪ ɑ
втім	v t̪ i m
хотілося	x ɔ t̪ i l̪ ɔ s̪ ɑ
зростання	z̪ r ɔ s̪ t̪ ɑ n̪ n̪ʲ ɑ
менше	m ɛ n̪ ʃ ɛ
використовувати	v ɪ k ɔ r ɪ s̪ t̪ ɔ v u v ɑ t̪ ɪ
усьому	u s̪ ɔ m u
Петербурзі	p ɛ t̪ ɛ r b u r z̪ʲ i
постійно	p ɔ s̪ t̪ i j n̪ ɔ
контролювати	k ɔ n̪ t̪ r ɔ lʲ u v ɑ t̪ ɪ
раз	r ɑ z̪
поза	p ɔ z̪ ɑ
переконати	p ɛ r ɛ k ɔ n̪ ɑ t̪ ɪ
програм	p r ɔ ɦ r ɑ m
Президента	p r ɛ z̪ ɪ d̪ ɛ n̪ t̪ ɑ
називається	n̪ ɑ z̪ ɪ v ɑ ɛ t̪ s̪ ɑ
Українське	u k r ɑ j i n̪ s̪ k ɛ
село	s̪ ɛ l̪ ɔ
когось	k ɔ ɦ ɔ s̪
майстерності	m ɑ j s̪ t̪ ɛ r n̪ ɔ s̪ t̪ i
шляхи	ʃ lʲ ɑ x ɪ
причина	p r ɪ t̪ ʃ ɪ n̪ ɑ
відсутність	v i d̪ s̪ u t̪ n̪ʲ i s̪ t̪
часто	t̪ ʃ ɑ s̪ t̪ ɔ
викликали	v ɪ k l̪ ɪ k ɑ l̪ ɪ
механізму	m ɛ x ɑ n̪ʲ i z̪ m u
звикли	z̪ v ɪ k l̪ ɪ
жодного	ʒ ɔ d̪ n̪ ɔ ɦ ɔ
фільму	f i lʲ m u
встановлені	v s̪ t̪ ɑ n̪ ɔ v l̪ ɛ n̪ʲ i
відбутися	v i d̪ b u t̪ ɪ s̪ ɑ
Київради	k ɪ j i v r ɑ d̪ ɪ
російський	r ɔ s̪ i j s̪ k ɪ j
слухач	s̪ l̪ u x ɑ t̪ ʃ
ТСН	t̪ s̪ n̪
Китаю	k ɪ t̪ ɑ u
втратила	v t̪ r ɑ t̪ ɪ l̪ ɑ
готовий	ɦ ɔ t̪ ɔ v ɪ j
Бога	b ɔ ɦ ɑ
режим	r ɛ ʒ ɪ m
радість	r ɑ d̪ʲ i s̪ t̪
школа	ʃ k ɔ l̪ ɑ
словами	s̪ l̪ ɔ v ɑ m ɪ
зустрітися	z̪ u s̪ t̪ rʲ i t̪ ɪ s̪ ɑ
фіналі	f i n̪ ɑ lʲ i
мовчав	m ɔ v t̪ ʃ ɑ v
глянув	ɦ lʲ ɑ n̪ u v
матір	m ɑ t̪ i r
голові	ɦ ɔ l̪ ɔ v i
якому	j ɑ k ɔ m u
чином	t̪ ʃ ɪ n̪ ɔ m
продажу	p r ɔ d̪ ɑ ʒ u
зайнятості	z̪ ɑ j n̪ʲ ɑ t̪ ɔ s̪ t̪ i
показати	p ɔ k ɑ z̪ ɑ t̪ ɪ
говоримо	ɦ ɔ v ɔ r ɪ m ɔ
самі	s̪ ɑ m i
банку	b ɑ n̪ k u
їхнє	j i x n̪ʲ ɛ
нинішній	n̪ ɪ n̪ʲ i ʃ n̪ʲ i j
посаді	p ɔ s̪ ɑ d̪ʲ i
при	p r ɪ
виникають	v ɪ n̪ ɪ k ɑ u t̪
символом	s̪ ɪ m v ɔ l̪ ɔ m
став	s̪ t̪ ɑ v
пізніше	p i z̪ n̪ʲ i ʃ ɛ
збільшує	z̪ b i lʲ ʃ u ɛ
експорт	ɛ k s̪ p ɔ r t̪
електроенергії	ɛ l̪ ɛ k t̪ r ɔ ɛ n̪ ɛ r ɦ i j i
Порошенко	p ɔ r ɔ ʃ ɛ n̪ k ɔ
Україною	u k r ɑ j i n̪ ɔ u
претензії	p r ɛ t̪ ɛ n̪ z̪ʲ i j i
правоохоронців	p r ɑ v ɔ ɔ x ɔ r ɔ n̪ t̪s̪ʲ i v
Портнов	p ɔ r t̪ n̪ ɔ v
міністром	m i n̪ʲ i s̪ t̪ r ɔ m
юстиції	j u s̪ t̪ ɪ t̪s̪ʲ i j i
слово	s̪ l̪ ɔ v ɔ
жодної	ʒ ɔ d̪ n̪ ɔ j i
радості	r ɑ d̪ ɔ s̪ t̪ i
передачі	p ɛ r ɛ d̪ ɑ t̪ ʃ i
оренду	ɔ r ɛ n̪ d̪ u
повного	p ɔ v n̪ ɔ ɦ ɔ
числі	t̪ ʃ ɪ s̪ lʲ i
вибуху	v ɪ b u x u
уникнути	u n̪ ɪ k n̪ u t̪ ɪ
перше	p ɛ r ʃ ɛ
звернення	z̪ v ɛ r n̪ ɛ n̪ n̪ʲ ɑ
обслуговування	ɔ b s̪ l̪ u ɦ ɔ v u v ɑ n̪ n̪ʲ ɑ
судна	s̪ u d̪ n̪ ɑ
команда	k ɔ m ɑ n̪ d̪ ɑ
мінімум	m i n̪ʲ i m u m
чотирьох	t̪ ʃ ɔ t̪ ɪ rʲ ɔ x
надають	n̪ ɑ d̪ ɑ u t̪
пішла	p i ʃ l̪ ɑ
садок	s̪ ɑ d̪ ɔ k
яблунею	j ɑ b l̪ u n̪ ɛ u
Сергій	s̪ ɛ r ɦ i j
почали	p ɔ t̪ ʃ ɑ l̪ ɪ
знищення	z̪ n̪ ɪ ʃ t̪ ʃ ɛ n̪ n̪ʲ ɑ
суть	s̪ u t̪
здатні	z̪ d̪ ɑ t̪ n̪ʲ i
світло	s̪ v i t̪ l̪ ɔ
подібного	p ɔ d̪ʲ i b n̪ ɔ ɦ ɔ
випадки	v ɪ p ɑ d̪ k ɪ
стає	s̪ t̪ ɑ ɛ
громадськості	ɦ r ɔ m ɑ d̪ s̪ k ɔ s̪ t̪ i
дізнатися	d̪ʲ i z̪ n̪ ɑ t̪ ɪ s̪ ɑ
статус	s̪ t̪ ɑ t̪ u s̪
жінки	ʒ i n̪ k ɪ
щодо	ʃ t̪ ʃ ɔ d̪ ɔ
дитини	d̪ ɪ t̪ ɪ n̪ ɪ
визначити	v ɪ z̪ n̪ ɑ t̪ ʃ ɪ t̪ ɪ
швидкості	ʃ v ɪ d̪ k ɔ s̪ t̪ i
зовсім	z̪ ɔ v s̪ i m
Вас	v ɑ s̪
заробляють	z̪ ɑ r ɔ b lʲ ɑ u t̪
проводили	p r ɔ v ɔ d̪ ɪ l̪ ɪ
Чернігові	t̪ ʃ ɛ r n̪ʲ i ɦ ɔ v i
вперше	v p ɛ r ʃ ɛ
стосується	s̪ t̪ ɔ s̪ u ɛ t̪ s̪ ɑ
мова	m ɔ v ɑ
відповідальність	v i d̪ p ɔ v i d̪ ɑ lʲ n̪ʲ i s̪ t̪
свідчить	s̪ v i d̪ t̪ ʃ ɪ t̪
однозначно	ɔ d̪ n̪ ɔ z̪ n̪ ɑ t̪ ʃ n̪ ɔ
художника	x u d̪ ɔ ʒ n̪ ɪ k ɑ
Іван	i v ɑ n̪
закінчив	z̪ ɑ k i n̪ t̪ ʃ ɪ v
Київський	k ɪ j i v s̪ k ɪ j
художній	x u d̪ ɔ ʒ n̪ʲ i j
інститут	i n̪ s̪ t̪ ɪ t̪ u t̪
пояснити	p ɔ ɑ s̪ n̪ ɪ t̪ ɪ
причини	p r ɪ t̪ ʃ ɪ n̪ ɪ
нападу	n̪ ɑ p ɑ d̪ u
повинна	p ɔ v ɪ n̪ n̪ ɑ
державна	d̪ ɛ r ʒ ɑ v n̪ ɑ
клубу	k l̪ u b u
бігти	b i ɦ t̪ ɪ
швидко	ʃ v ɪ d̪ k ɔ
розповів	r ɔ z̪ p ɔ v i v
правоохоронцям	p r ɑ v ɔ ɔ x ɔ r ɔ n̪ t̪s̪ʲ ɑ m
трапилася	t̪ r ɑ p ɪ l̪ ɑ s̪ ɑ
спробували	s̪ p r ɔ b u v ɑ l̪ ɪ
зупинити	z̪ u p ɪ n̪ ɪ t̪ ɪ
додав	d̪ ɔ d̪ ɑ v
газу	ɦ ɑ z̪ u
змінити	z̪ m i n̪ ɪ t̪ ɪ
підхід	p i d̪ x i d̪
очищення	ɔ t̪ ʃ ɪ ʃ t̪ ʃ ɛ n̪ n̪ʲ ɑ
ділянку	d̪ʲ i lʲ ɑ n̪ k u
громада	ɦ r ɔ m ɑ d̪ ɑ
журналісти	ʒ u r n̪ ɑ lʲ i s̪ t̪ ɪ
господарі	ɦ ɔ s̪ p ɔ d̪ ɑ rʲ i
сусіди	s̪ u s̪ i d̪ ɪ
третя	t̪ r ɛ t̪ ɑ
поспіль	p ɔ s̪ p i lʲ
перемога	p ɛ r ɛ m ɔ ɦ ɑ
марафоні	m ɑ r ɑ f ɔ n̪ʲ i
обличчя	ɔ b l̪ ɪ t̪ ʃ t̪ ʃ ɑ
одяг	ɔ d̪ʲ ɑ ɦ
душа	d̪ u ʃ ɑ
думки	d̪ u m k ɪ
експертів	ɛ k s̪ p ɛ r t̪ i v
політиків	p ɔ lʲ i t̪ ɪ k i v
абсолютно	ɑ b s̪ ɔ lʲ u t̪ n̪ ɔ
розуміють	r ɔ z̪ u m i u t̪
часу	t̪ ʃ ɑ s̪ u
діють	d̪ʲ i u t̪
напрямі	n̪ ɑ p rʲ ɑ m i
якесь	j ɑ k ɛ s̪
моє	m ɔ ɛ
лікування	lʲ i k u v ɑ n̪ n̪ʲ ɑ
мабуть	m ɑ b u t̪
кордон	k ɔ r d̪ ɔ n̪
входить	v x ɔ d̪ ɪ t̪
певний	p ɛ v n̪ ɪ j
перелік	p ɛ r ɛ lʲ i k
виплат	v ɪ p l̪ ɑ t̪
впливає	v p l̪ ɪ v ɑ ɛ
вартість	v ɑ r t̪ i s̪ t̪
виклики	v ɪ k l̪ ɪ k ɪ
наша	n̪ ɑ ʃ ɑ
інформація	i n̪ f ɔ r m ɑ t̪s̪ʲ i ɑ
першої	p ɛ r ʃ ɔ j i
особи	ɔ s̪ ɔ b ɪ
говорить	ɦ ɔ v ɔ r ɪ t̪
хлопчик	x l̪ ɔ p t̪ ʃ ɪ k
незабаром	n̪ ɛ z̪ ɑ b ɑ r ɔ m
помер	p ɔ m ɛ r
владі	v l̪ ɑ d̪ʲ i
переважна	p ɛ r ɛ v ɑ ʒ n̪ ɑ
більшість	b i lʲ ʃ i s̪ t̪
свята	s̪ v ɑ t̪ ɑ
цієї	t̪s̪ʲ i ɛ j i
медалі	m ɛ d̪ ɑ lʲ i
будувати	b u d̪ u v ɑ t̪ ɪ
питаю	p ɪ t̪ ɑ u
ухвалили	u x v ɑ l̪ ɪ l̪ ɪ
депутати	d̪ ɛ p u t̪ ɑ t̪ ɪ
ради	r ɑ d̪ ɪ
тих	t̪ ɪ x
районах	r ɑ j ɔ n̪ ɑ x
тиждень	t̪ ɪ ʒ d̪ ɛ n̪ʲ
місцевого	m i s̪ t̪s̪ ɛ v ɔ ɦ ɔ
самоврядування	s̪ ɑ m ɔ v rʲ ɑ d̪ u v ɑ n̪ n̪ʲ ɑ
учора	u t̪ ʃ ɔ r ɑ
червоні	t̪ ʃ ɛ r v ɔ n̪ʲ i
оголосили	ɔ ɦ ɔ l̪ ɔ s̪ ɪ l̪ ɪ
голодування	ɦ ɔ l̪ ɔ d̪ u v ɑ n̪ n̪ʲ ɑ
знак	z̪ n̪ ɑ k
протесту	p r ɔ t̪ ɛ s̪ t̪ u
швидше	ʃ v ɪ d̪ ʃ ɛ
студенти	s̪ t̪ u d̪ ɛ n̪ t̪ ɪ
субота	s̪ u b ɔ t̪ ɑ
нашомі	n̪ ɑ ʃ ɔ m i
третю	t̪ r ɛ t̪ u
виходу	v ɪ x ɔ d̪ u
іншому	i n̪ ʃ ɔ m u
належать	n̪ ɑ l̪ ɛ ʒ ɑ t̪
прийшли	p r ɪ j ʃ l̪ ɪ
Івана	i v ɑ n̪ ɑ
засоби	z̪ ɑ s̪ ɔ b ɪ
цікаво	t̪s̪ʲ i k ɑ v ɔ
українською	u k r ɑ j i n̪ s̪ k ɔ u
боротьби	b ɔ r ɔ t̪ b ɪ
боку	b ɔ k u
працівник	p r ɑ t̪s̪ʲ i v n̪ ɪ k
підписали	p i d̪ p ɪ s̪ ɑ l̪ ɪ
загалом	z̪ ɑ ɦ ɑ l̪ ɔ m
враження	v r ɑ ʒ ɛ n̪ n̪ʲ ɑ
закону	z̪ ɑ k ɔ n̪ u
помчалась	p ɔ m t̪ ʃ ɑ l̪ ɑ s̪
вподовж	v p ɔ d̪ ɔ v ʒ
ниви	n̪ ɪ v ɪ
повернення	p ɔ v ɛ r n̪ ɛ n̪ n̪ʲ ɑ
трудових	t̪ r u d̪ ɔ v ɪ x
мігрантів	m i ɦ r ɑ n̪ t̪ i v
ніяких	n̪ʲ i ɑ k ɪ x
підстав	p i d̪ s̪ t̪ ɑ v
грудні	ɦ r u d̪ n̪ʲ i
переможці	p ɛ r ɛ m ɔ ʒ t̪s̪ʲ i
стануть	s̪ t̪ ɑ n̪ u t̪
літа	lʲ i t̪ ɑ
цур	t̪s̪ u r
тобі	t̪ ɔ b i
злякав	z̪ lʲ ɑ k ɑ v
замовкла	z̪ ɑ m ɔ v k l̪ ɑ
бізнес	b i z̪ n̪ ɛ s̪
неможливо	n̪ ɛ m ɔ ʒ l̪ ɪ v ɔ
оце	ɔ t̪s̪ ɛ
вам	v ɑ m
мого	m ɔ ɦ ɔ
півня	p i v n̪ʲ ɑ
раду	r ɑ d̪ u
дедалі	d̪ ɛ d̪ ɑ lʲ i
іншої	i n̪ ʃ ɔ j i
розмови	r ɔ z̪ m ɔ v ɪ
законопроект	z̪ ɑ k ɔ n̪ ɔ p r ɔ ɛ k t̪
перебуває	p ɛ r ɛ b u v ɑ ɛ
стадії	s̪ t̪ ɑ d̪ʲ i j i
розробки	r ɔ z̪ r ɔ b k ɪ
аніж	ɑ n̪ʲ i ʒ
реально	r ɛ ɑ lʲ n̪ ɔ
створюють	s̪ t̪ v ɔ rʲ u u t̪
руку	r u k u
Євгена	j ɛ v ɦ ɛ n̪ ɑ
Коновальця	k ɔ n̪ ɔ v ɑ lʲ t̪s̪ʲ ɑ
фактично	f ɑ k t̪ ɪ t̪ ʃ n̪ ɔ
робить	r ɔ b ɪ t̪
продукт	p r ɔ d̪ u k t̪
надто	n̪ ɑ d̪ t̪ ɔ
суспільство	s̪ u s̪ p i lʲ s̪ t̪ v ɔ
дозволяє	d̪ ɔ z̪ v ɔ lʲ ɑ ɛ
міст	m i s̪ t̪
залишилися	z̪ ɑ l̪ ɪ ʃ ɪ l̪ ɪ s̪ ɑ
опалення	ɔ p ɑ l̪ ɛ n̪ n̪ʲ ɑ
расова	r ɑ s̪ ɔ v ɑ
дискримінація	d̪ ɪ s̪ k r ɪ m i n̪ ɑ t̪s̪ʲ i ɑ
візові	v i z̪ ɔ v i
основних	ɔ s̪ n̪ ɔ v n̪ ɪ x
Бог	b ɔ ɦ
милосердний	m ɪ l̪ ɔ s̪ ɛ r d̪ n̪ ɪ j
держить	d̪ ɛ r ʒ ɪ t̪
Вищої	v ɪ ʃ t̪ ʃ ɔ j i
години	ɦ ɔ d̪ ɪ n̪ ɪ
цілий	t̪s̪ʲ i l̪ ɪ j
побував	p ɔ b u v ɑ v
міністра	m i n̪ʲ i s̪ t̪ r ɑ
занадто	z̪ ɑ n̪ ɑ d̪ t̪ ɔ
вдома	v d̪ ɔ m ɑ
мої	m ɔ j i
картину	k ɑ r t̪ ɪ n̪ u
рідний	rʲ i d̪ n̪ ɪ j
дім	d̪ʲ i m
Львові	lʲ v ɔ v i
десяте	d̪ ɛ s̪ ɑ t̪ ɛ
жовтня	ʒ ɔ v t̪ n̪ʲ ɑ
двадцять	d̪ v ɑ d̪ t̪s̪ʲ ɑ t̪
перша	p ɛ r ʃ ɑ
отож	ɔ t̪ ɔ ʒ
зібрали	z̪ʲ i b r ɑ l̪ ɪ
усіх	u s̪ i x
бажаючих	b ɑ ʒ ɑ u t̪ ʃ ɪ x
біля	b i lʲ ɑ
входу	v x ɔ d̪ u
Національний	n̪ ɑ t̪s̪ʲ i ɔ n̪ ɑ lʲ n̪ ɪ j
важливі	v ɑ ʒ l̪ ɪ v i
всьому	v s̪ ɔ m u
нашому	n̪ ɑ ʃ ɔ m u
помилки	p ɔ m ɪ l̪ k ɪ
коротко	k ɔ r ɔ t̪ k ɔ
порядність	p ɔ rʲ ɑ d̪ n̪ʲ i s̪ t̪
чоловічу	t̪ ʃ ɔ l̪ ɔ v i t̪ ʃ u
дружбу	d̪ r u ʒ b u
туди	t̪ u d̪ ɪ
звертатися	z̪ v ɛ r t̪ ɑ t̪ ɪ s̪ ɑ
особисто	ɔ s̪ ɔ b ɪ s̪ t̪ ɔ
родини	r ɔ d̪ ɪ n̪ ɪ
хоча	x ɔ t̪ ʃ ɑ
вчора	v t̪ ʃ ɔ r ɑ
сімнадцяте	s̪ i m n̪ ɑ d̪ t̪s̪ʲ ɑ t̪ ɛ
березня	b ɛ r ɛ z̪ n̪ʲ ɑ
дванадцятого	d̪ v ɑ n̪ ɑ d̪ t̪s̪ʲ ɑ t̪ ɔ ɦ ɔ
позицію	p ɔ z̪ ɪ t̪s̪ʲ i u
політичні	p ɔ lʲ i t̪ ɪ t̪ ʃ n̪ʲ i
сили	s̪ ɪ l̪ ɪ
намагалися	n̪ ɑ m ɑ ɦ ɑ l̪ ɪ s̪ ɑ
встановити	v s̪ t̪ ɑ n̪ ɔ v ɪ t̪ ɪ
українські	u k r ɑ j i n̪ s̪ k i
польські	p ɔ lʲ s̪ k i
науковці	n̪ ɑ u k ɔ v t̪s̪ʲ i
повернула	p ɔ v ɛ r n̪ u l̪ ɑ
круто	k r u t̪ ɔ
наліво	n̪ ɑ lʲ i v ɔ
ніяк	n̪ʲ i ɑ k
Павличко	p ɑ v l̪ ɪ t̪ ʃ k ɔ
Володимир	v ɔ l̪ ɔ d̪ ɪ m ɪ r
Яворівський	j ɑ v ɔ rʲ i v s̪ k ɪ j
відома	v i d̪ ɔ m ɑ
створює	s̪ t̪ v ɔ rʲ u ɛ
хворих	x v ɔ r ɪ x
кредитування	k r ɛ d̪ ɪ t̪ u v ɑ n̪ n̪ʲ ɑ
одно	ɔ d̪ n̪ ɔ
триватиме	t̪ r ɪ v ɑ t̪ ɪ m ɛ
жила	ʒ ɪ l̪ ɑ
публічно	p u b lʲ i t̪ ʃ n̪ ɔ
внесок	v n̪ ɛ s̪ ɔ k
кармазин	k ɑ r m ɑ z̪ ɪ n̪
уста	u s̪ t̪ ɑ
святого	s̪ v ɑ t̪ ɔ ɦ ɔ
змушені	z̪ m u ʃ ɛ n̪ʲ i
нації	n̪ ɑ t̪s̪ʲ i j i
парадоксів	p ɑ r ɑ d̪ ɔ k s̪ i v
мрія	m rʲ i ɑ
кожної	k ɔ ʒ n̪ ɔ j i
перемоги	p ɛ r ɛ m ɔ ɦ ɪ
існує	i s̪ n̪ u ɛ
версії	v ɛ r s̪ i j i
походження	p ɔ x ɔ d̪ ʒ ɛ n̪ n̪ʲ ɑ
назви	n̪ ɑ z̪ v ɪ
кілометрів	k i l̪ ɔ m ɛ t̪ rʲ i v
зберегти	z̪ b ɛ r ɛ ɦ t̪ ɪ
хоче	x ɔ t̪ ʃ ɛ
знищити	z̪ n̪ ɪ ʃ t̪ ʃ ɪ t̪ ɪ
місцевому	m i s̪ t̪s̪ ɛ v ɔ m u
кордоном	k ɔ r d̪ ɔ n̪ ɔ m
Кварцяний	k v ɑ r t̪s̪ʲ ɑ n̪ ɪ j
стане	s̪ t̪ ɑ n̪ ɛ
експертом	ɛ k s̪ p ɛ r t̪ ɔ m
програми	p r ɔ ɦ r ɑ m ɪ
футбол	f u t̪ b ɔ l̪
передали	p ɛ r ɛ d̪ ɑ l̪ ɪ
економічні	ɛ k ɔ n̪ ɔ m i t̪ ʃ n̪ʲ i
реформи	r ɛ f ɔ r m ɪ
ключ	k lʲ u t̪ ʃ
успіху	u s̪ p i x u
вибір	v ɪ b i r
підписав	p i d̪ p ɪ s̪ ɑ v
Європа	j ɛ v r ɔ p ɑ
європейська	j ɛ v r ɔ p ɛ j s̪ k ɑ
приходить	p r ɪ x ɔ d̪ ɪ t̪
отруєння	ɔ t̪ r u ɛ n̪ n̪ʲ ɑ
порядку	p ɔ rʲ ɑ d̪ k u
діждали	d̪ʲ i ʒ d̪ ɑ l̪ ɪ
город	ɦ ɔ r ɔ d̪
одкопала	ɔ d̪ k ɔ p ɑ l̪ ɑ
скопала	s̪ k ɔ p ɑ l̪ ɑ
засадила	z̪ ɑ s̪ ɑ d̪ ɪ l̪ ɑ
управлінні	u p r ɑ v lʲ i n̪ n̪ʲ i
прав	p r ɑ v
споживачів	s̪ p ɔ ʒ ɪ v ɑ t̪ ʃ i v
умови	u m ɔ v ɪ
ефективної	ɛ f ɛ k t̪ ɪ v n̪ ɔ j i
власності	v l̪ ɑ s̪ n̪ ɔ s̪ t̪ i
кудись	k u d̪ ɪ s̪
поділися	p ɔ d̪ʲ i l̪ ɪ s̪ ɑ
голоси	ɦ ɔ l̪ ɔ s̪ ɪ
народу	n̪ ɑ r ɔ d̪ u
проханням	p r ɔ x ɑ n̪ n̪ʲ ɑ m
невеликий	n̪ ɛ v ɛ l̪ ɪ k ɪ j
виходять	v ɪ x ɔ d̪ʲ ɑ t̪
жителі	ʒ ɪ t̪ ɛ lʲ i
країн	k r ɑ j i n̪
хотів	x ɔ t̪ i v
заробити	z̪ ɑ r ɔ b ɪ t̪ ɪ
постачання	p ɔ s̪ t̪ ɑ t̪ ʃ ɑ n̪ n̪ʲ ɑ
почалися	p ɔ t̪ ʃ ɑ l̪ ɪ s̪ ɑ
Лушня	l̪ u ʃ n̪ʲ ɑ
пристає	p r ɪ s̪ t̪ ɑ ɛ
Дмитра	d̪ m ɪ t̪ r ɑ
сидів	s̪ ɪ d̪ʲ i v
Леонід	l̪ ɛ ɔ n̪ʲ i d̪
Кучма	k u t̪ ʃ m ɑ
давно	d̪ ɑ v n̪ ɔ
склали	s̪ k l̪ ɑ l̪ ɪ
відповідь	v i d̪ p ɔ v i d̪ʲ
зауваження	z̪ ɑ u v ɑ ʒ ɛ n̪ n̪ʲ ɑ
десятий	d̪ ɛ s̪ ɑ t̪ ɪ j
складним	s̪ k l̪ ɑ d̪ n̪ ɪ m
ішов	i ʃ ɔ v
захожий	z̪ ɑ x ɔ ʒ ɪ j
нога	n̪ ɔ ɦ ɑ
ногою	n̪ ɔ ɦ ɔ u
веселі	v ɛ s̪ ɛ lʲ i
брате	b r ɑ t̪ ɛ
часи	t̪ ʃ ɑ s̪ ɪ
настали	n̪ ɑ s̪ t̪ ɑ l̪ ɪ
редактор	r ɛ d̪ ɑ k t̪ ɔ r
позбавлення	p ɔ z̪ b ɑ v l̪ ɛ n̪ n̪ʲ ɑ
волі	v ɔ lʲ i
виключно	v ɪ k lʲ u t̪ ʃ n̪ ɔ
Києва	k ɪ ɛ v ɑ
мешканці	m ɛ ʃ k ɑ n̪ t̪s̪ʲ i
даху	d̪ ɑ x u
відповідного	v i d̪ p ɔ v i d̪ n̪ ɔ ɦ ɔ
документів	d̪ ɔ k u m ɛ n̪ t̪ i v
Чорноморського	t̪ ʃ ɔ r n̪ ɔ m ɔ r s̪ k ɔ ɦ ɔ
флоту	f l̪ ɔ t̪ u
постійне	p ɔ s̪ t̪ i j n̪ ɛ
прагнення	p r ɑ ɦ n̪ ɛ n̪ n̪ʲ ɑ
Феттеля	f ɛ t̪ t̪ ɛ lʲ ɑ
Дніпропетровської	d̪ n̪ʲ i p r ɔ p ɛ t̪ r ɔ v s̪ k ɔ j i
бій	b i j
цих	t̪s̪ ɪ x
співробітники	s̪ p i v r ɔ b i t̪ n̪ ɪ k ɪ
побачили	p ɔ b ɑ t̪ ʃ ɪ l̪ ɪ
єдиний	j ɛ d̪ ɪ n̪ ɪ j
потугувала	p ɔ t̪ u ɦ u v ɑ l̪ ɑ
ночі	n̪ ɔ t̪ ʃ i
голосом	ɦ ɔ l̪ ɔ s̪ ɔ m
викрикуючи	v ɪ k r ɪ k u u t̪ ʃ ɪ
сім	s̪ i m
'	j
ї	j i
діти	d̪ʲ i t̪ ɪ
розуміння	r ɔ z̪ u m i n̪ n̪ʲ ɑ
отак	ɔ t̪ ɑ k
прожив	p r ɔ ʒ ɪ v
першу	p ɛ r ʃ u
сфері	s̪ f ɛ rʲ i
економічного	ɛ k ɔ n̪ ɔ m i t̪ ʃ n̪ ɔ ɦ ɔ
співробітництва	s̪ p i v r ɔ b i t̪ n̪ ɪ t̪s̪ t̪ v ɑ
органу	ɔ r ɦ ɑ n̪ u
гріх	ɦ rʲ i x
науки	n̪ ɑ u k ɪ
культури	k u lʲ t̪ u r ɪ
мистецтва	m ɪ s̪ t̪ ɛ t̪s̪ t̪ v ɑ
фестивалі	f ɛ s̪ t̪ ɪ v ɑ lʲ i
думаю	d̪ u m ɑ u
розвивається	r ɔ z̪ v ɪ v ɑ ɛ t̪ s̪ ɑ
запевнив	z̪ ɑ p ɛ v n̪ ɪ v
українському	u k r ɑ j i n̪ s̪ k ɔ m u
переконаний	p ɛ r ɛ k ɔ n̪ ɑ n̪ ɪ j
успішно	u s̪ p i ʃ n̪ ɔ
самому	s̪ ɑ m ɔ m u
будинку	b u d̪ ɪ n̪ k u
виявлено	v ɪ ɑ v l̪ ɛ n̪ ɔ
коштує	k ɔ ʃ t̪ u ɛ
дверей	d̪ v ɛ r ɛ j
спочатку	s̪ p ɔ t̪ ʃ ɑ t̪ k u
спорудження	s̪ p ɔ r u d̪ ʒ ɛ n̪ n̪ʲ ɑ
виступили	v ɪ s̪ t̪ u p ɪ l̪ ɪ
міські	m i s̪ k i
брат	b r ɑ t̪
сестра	s̪ ɛ s̪ t̪ r ɑ
четверо	t̪ ʃ ɛ t̪ v ɛ r ɔ
Шевченко	ʃ ɛ v t̪ ʃ ɛ n̪ k ɔ
допоможе	d̪ ɔ p ɔ m ɔ ʒ ɛ
конкретно	k ɔ n̪ k r ɛ t̪ n̪ ɔ
молодий	m ɔ l̪ ɔ d̪ ɪ j
умов	u m ɔ v
знайомство	z̪ n̪ ɑ j ɔ m s̪ t̪ v ɔ
почути	p ɔ t̪ ʃ u t̪ ɪ
висновки	v ɪ s̪ n̪ ɔ v k ɪ
виросли	v ɪ r ɔ s̪ l̪ ɪ
називає	n̪ ɑ z̪ ɪ v ɑ ɛ
Міжнародний	m i ʒ n̪ ɑ r ɔ d̪ n̪ ɪ j
валютний	v ɑ lʲ u t̪ n̪ ɪ j
фонд	f ɔ n̪ d̪
майбутній	m ɑ j b u t̪ n̪ʲ i j
розвиток	r ɔ z̪ v ɪ t̪ ɔ k
подій	p ɔ d̪ʲ i j
чверть	t̪ ʃ v ɛ r t̪
червні	t̪ ʃ ɛ r v n̪ʲ i
світить	s̪ v i t̪ ɪ t̪
семи	s̪ ɛ m ɪ
моя	m ɔ ɑ
думка	d̪ u m k ɑ
дати	d̪ ɑ t̪ ɪ
Харків	x ɑ r k i v
другим	d̪ r u ɦ ɪ m
глава	ɦ l̪ ɑ v ɑ
святкування	s̪ v ɑ t̪ k u v ɑ n̪ n̪ʲ ɑ
згодом	z̪ ɦ ɔ d̪ ɔ m
зроблено	z̪ r ɔ b l̪ ɛ n̪ ɔ
підсумками	p i d̪ s̪ u m k ɑ m ɪ
поле	p ɔ l̪ ɛ
аж	ɑ ʒ
згадати	z̪ ɦ ɑ d̪ ɑ t̪ ɪ
тренера	t̪ r ɛ n̪ ɛ r ɑ
діяти	d̪ʲ i ɑ t̪ ɪ
відповідно	v i d̪ p ɔ v i d̪ n̪ ɔ
практично	p r ɑ k t̪ ɪ t̪ ʃ n̪ ɔ
спорту	s̪ p ɔ r t̪ u
документи	d̪ ɔ k u m ɛ n̪ t̪ ɪ
впала	v p ɑ l̪ ɑ
крові	k r ɔ v i
країну	k r ɑ j i n̪ u
кажу	k ɑ ʒ u
тижнів	t̪ ɪ ʒ n̪ʲ i v
новини	n̪ ɔ v ɪ n̪ ɪ
стосовно	s̪ t̪ ɔ s̪ ɔ v n̪ ɔ
прикладом	p r ɪ k l̪ ɑ d̪ ɔ m
ходити	x ɔ d̪ ɪ t̪ ɪ
жодному	ʒ ɔ d̪ n̪ ɔ m u
разі	r ɑ z̪ʲ i
високий	v ɪ s̪ ɔ k ɪ j
рівень	rʲ i v ɛ n̪ʲ
продукції	p r ɔ d̪ u k t̪s̪ʲ i j i
підприємств	p i d̪ p r ɪ ɛ m s̪ t̪ v
реанімації	r ɛ ɑ n̪ʲ i m ɑ t̪s̪ʲ i j i
подала	p ɔ d̪ ɑ l̪ ɑ
будівництво	b u d̪ʲ i v n̪ ɪ t̪s̪ t̪ v ɔ
облради	ɔ b l̪ r ɑ d̪ ɪ
вранці	v r ɑ n̪ t̪s̪ʲ i
другий	d̪ r u ɦ ɪ j
вечір	v ɛ t̪ ʃ i r
Київ	k ɪ j i v
всім	v s̪ i m
пашпорті	p ɑ ʃ p ɔ r t̪ i
Хрущем	x r u ʃ t̪ ʃ ɛ m
пишеться	p ɪ ʃ ɛ t̪ s̪ ɑ
роботі	r ɔ b ɔ t̪ i
якби	j ɑ k b ɪ
регіонал	r ɛ ɦ i ɔ n̪ ɑ l̪
визнав	v ɪ z̪ n̪ ɑ v
вини	v ɪ n̪ ɪ
українська	u k r ɑ j i n̪ s̪ k ɑ
назвати	n̪ ɑ z̪ v ɑ t̪ ɪ
оточення	ɔ t̪ ɔ t̪ ʃ ɛ n̪ n̪ʲ ɑ
спільне	s̪ p i lʲ n̪ ɛ
компанії	k ɔ m p ɑ n̪ʲ i j i
ставити	s̪ t̪ ɑ v ɪ t̪ ɪ
мету	m ɛ t̪ u
СРСР	s̪ r s̪ r
нехай	n̪ ɛ x ɑ j
чорні	t̪ ʃ ɔ r n̪ʲ i
гайворон	ɦ ɑ j v ɔ r ɔ n̪
уси	u s̪ ɪ
починали	p ɔ t̪ ʃ ɪ n̪ ɑ l̪ ɪ
краях	k r ɑ ɑ x
рудіти	r u d̪ʲ i t̪ ɪ
восьмого	v ɔ s̪ m ɔ ɦ ɔ
Степан	s̪ t̪ ɛ p ɑ n̪
одружилися	ɔ d̪ r u ʒ ɪ l̪ ɪ s̪ ɑ
продовжує	p r ɔ d̪ ɔ v ʒ u ɛ
Рада	r ɑ d̪ ɑ
кращий	k r ɑ ʃ t̪ ʃ ɪ j
Чіпка	t̪ ʃ i p k ɑ
грізно	ɦ rʲ i z̪ n̪ ɔ
зиркнув	z̪ ɪ r k n̪ u v
широкого	ʃ ɪ r ɔ k ɔ ɦ ɔ
Верховна	v ɛ r x ɔ v n̪ ɑ
великий	v ɛ l̪ ɪ k ɪ j
візит	v i z̪ ɪ t̪
рівня	rʲ i v n̪ʲ ɑ
відбувся	v i d̪ b u v s̪ ɑ
матері	m ɑ t̪ ɛ rʲ i
вічі	v i t̪ ʃ i
цілому	t̪s̪ʲ i l̪ ɔ m u
тяглося	t̪ ɑ ɦ l̪ ɔ s̪ ɑ
цілі	t̪s̪ʲ i lʲ i
довгі	d̪ ɔ v ɦ i
віки	v i k ɪ
шляхетського	ʃ lʲ ɑ x ɛ t̪ s̪ k ɔ ɦ ɔ
панування	p ɑ n̪ u v ɑ n̪ n̪ʲ ɑ
загрозою	z̪ ɑ ɦ r ɔ z̪ ɔ u
хвиля	x v ɪ lʲ ɑ
чортеня	t̪ ʃ ɔ r t̪ ɛ n̪ʲ ɑ
годі	ɦ ɔ d̪ʲ i
поляків	p ɔ lʲ ɑ k i v
своя	s̪ v ɔ ɑ
відсотків	v i d̪ s̪ ɔ t̪ k i v
чим	t̪ ʃ ɪ m
збільшення	z̪ b i lʲ ʃ ɛ n̪ n̪ʲ ɑ
виходить	v ɪ x ɔ d̪ ɪ t̪
особливо	ɔ s̪ ɔ b l̪ ɪ v ɔ
європейської	j ɛ v r ɔ p ɛ j s̪ k ɔ j i
інтеграції	i n̪ t̪ ɛ ɦ r ɑ t̪s̪ʲ i j i
узагалі	u z̪ ɑ ɦ ɑ lʲ i
суті	s̪ u t̪ i
вміє	v m i ɛ
Роналду	r ɔ n̪ ɑ l̪ d̪ u
Мессі	m ɛ s̪ s̪ i
мить	m ɪ t̪
спробувати	s̪ p r ɔ b u v ɑ t̪ ɪ
визначення	v ɪ z̪ n̪ ɑ t̪ ʃ ɛ n̪ n̪ʲ ɑ
надії	n̪ ɑ d̪ʲ i j i
європейськими	j ɛ v r ɔ p ɛ j s̪ k ɪ m ɪ
українськими	u k r ɑ j i n̪ s̪ k ɪ m ɪ
реальний	r ɛ ɑ lʲ n̪ ɪ j
сектор	s̪ ɛ k t̪ ɔ r
школі	ʃ k ɔ lʲ i
допомагає	d̪ ɔ p ɔ m ɑ ɦ ɑ ɛ
вся	v s̪ ɑ
парубок	p ɑ r u b ɔ k
спеціальних	s̪ p ɛ t̪s̪ʲ i ɑ lʲ n̪ ɪ x
школах	ʃ k ɔ l̪ ɑ x
боргів	b ɔ r ɦ i v
Росією	r ɔ s̪ i ɛ u
діяльність	d̪ʲ i ɑ lʲ n̪ʲ i s̪ t̪
групі	ɦ r u p i
пощастило	p ɔ ʃ t̪ ʃ ɑ s̪ t̪ ɪ l̪ ɔ
призьбу	p r ɪ z̪ʲ b u
жовтою	ʒ ɔ v t̪ ɔ u
глиною	ɦ l̪ ɪ n̪ ɔ u
підвела	p i d̪ v ɛ l̪ ɑ
окремі	ɔ k r ɛ m i
положення	p ɔ l̪ ɔ ʒ ɛ n̪ n̪ʲ ɑ
Білорусь	b i l̪ ɔ r u s̪
Росія	r ɔ s̪ i ɑ
Китай	k ɪ t̪ ɑ j
висновок	v ɪ s̪ n̪ ɔ v ɔ k
любов	lʲ u b ɔ v
виховання	v ɪ x ɔ v ɑ n̪ n̪ʲ ɑ
полягає	p ɔ lʲ ɑ ɦ ɑ ɛ
комісії	k ɔ m i s̪ i j i
принципі	p r ɪ n̪ t̪s̪ ɪ p i
нового	n̪ ɔ v ɔ ɦ ɔ
повідомили	p ɔ v i d̪ ɔ m ɪ l̪ ɪ
збігла	z̪ b i ɦ l̪ ɑ
прудко	p r u d̪ k ɔ
згірок	z̪ ɦ i r ɔ k
демократичних	d̪ ɛ m ɔ k r ɑ t̪ ɪ t̪ ʃ n̪ ɪ x
країнах	k r ɑ j i n̪ ɑ x
регулярно	r ɛ ɦ u lʲ ɑ r n̪ ɔ
проводяться	p r ɔ v ɔ d̪ʲ ɑ t̪ s̪ ɑ
розуміти	r ɔ z̪ u m i t̪ ɪ
хлопців	x l̪ ɔ p t̪s̪ʲ i v
планується	p l̪ ɑ n̪ u ɛ t̪ s̪ ɑ
реалізувати	r ɛ ɑ lʲ i z̪ u v ɑ t̪ ɪ
підтримки	p i d̪ t̪ r ɪ m k ɪ
лютого	lʲ u t̪ ɔ ɦ ɔ
мороз	m ɔ r ɔ z̪
спиною	s̪ p ɪ n̪ ɔ u
складно	s̪ k l̪ ɑ d̪ n̪ ɔ
Ярослав	j ɑ r ɔ s̪ l̪ ɑ v
Попович	p ɔ p ɔ v ɪ t̪ ʃ
виступить	v ɪ s̪ t̪ u p ɪ t̪
Тур	t̪ u r
Франс	f r ɑ n̪ s̪
розслідування	r ɔ z̪ s̪ lʲ i d̪ u v ɑ n̪ n̪ʲ ɑ
обставин	ɔ b s̪ t̪ ɑ v ɪ n̪
пожежі	p ɔ ʒ ɛ ʒ i
літ	lʲ i t̪
імена	i m ɛ n̪ ɑ
виконувати	v ɪ k ɔ n̪ u v ɑ t̪ ɪ
Тараса	t̪ ɑ r ɑ s̪ ɑ
травня	t̪ r ɑ v n̪ʲ ɑ
обласна	ɔ b l̪ ɑ s̪ n̪ ɑ
рада	r ɑ d̪ ɑ
прийняла	p r ɪ j n̪ʲ ɑ l̪ ɑ
виділення	v ɪ d̪ʲ i l̪ ɛ n̪ n̪ʲ ɑ
пункті	p u n̪ k t̪ i
першому	p ɛ r ʃ ɔ m u
розпорядження	r ɔ z̪ p ɔ rʲ ɑ d̪ ʒ ɛ n̪ n̪ʲ ɑ
планують	p l̪ ɑ n̪ u u t̪
дефіцит	d̪ ɛ f i t̪s̪ ɪ t̪
бюджету	b u d̪ ʒ ɛ t̪ u
стояли	s̪ t̪ ɔ ɑ l̪ ɪ
дані	d̪ ɑ n̪ʲ i
підвищення	p i d̪ v ɪ ʃ t̪ ʃ ɛ n̪ n̪ʲ ɑ
зарплати	z̪ ɑ r p l̪ ɑ t̪ ɪ
повсякденно	p ɔ v s̪ ɑ k d̪ ɛ n̪ n̪ ɔ
займаються	z̪ ɑ j m ɑ u t̪ s̪ ɑ
педагогічною	p ɛ d̪ ɑ ɦ ɔ ɦ i t̪ ʃ n̪ ɔ u
науковою	n̪ ɑ u k ɔ v ɔ u
діяльністю	d̪ʲ i ɑ lʲ n̪ʲ i s̪ t̪ u
добра	d̪ ɔ b r ɑ
розповіла	r ɔ z̪ p ɔ v i l̪ ɑ
бабусі	b ɑ b u s̪ i
церкви	t̪s̪ ɛ r k v ɪ
неділя	n̪ ɛ d̪ʲ i lʲ ɑ
шосте	ʃ ɔ s̪ t̪ ɛ
тисячи	t̪ ɪ s̪ ɑ t̪ ʃ ɪ
книги	k n̪ ɪ ɦ ɪ
молодих	m ɔ l̪ ɔ d̪ ɪ x
очолив	ɔ t̪ ʃ ɔ l̪ ɪ v
відділ	v i d̪ d̪ʲ i l̪
забрали	z̪ ɑ b r ɑ l̪ ɪ
встиг	v s̪ t̪ ɪ ɦ
оскільки	ɔ s̪ k i lʲ k ɪ
затримано	z̪ ɑ t̪ r ɪ m ɑ n̪ ɔ
місяць	m i s̪ ɑ t̪s̪ʲ
писав	p ɪ s̪ ɑ v
програму	p r ɔ ɦ r ɑ m u
депутата	d̪ ɛ p u t̪ ɑ t̪ ɑ
агентство	ɑ ɦ ɛ n̪ t̪ s̪ t̪ v ɔ
Українські	u k r ɑ j i n̪ s̪ k i
затверджено	z̪ ɑ t̪ v ɛ r d̪ ʒ ɛ n̪ ɔ
кличе	k l̪ ɪ t̪ ʃ ɛ
конкретних	k ɔ n̪ k r ɛ t̪ n̪ ɪ x
людині	lʲ u d̪ ɪ n̪ʲ i
людина	lʲ u d̪ ɪ n̪ ɑ
четвер	t̪ ʃ ɛ t̪ v ɛ r
Кривому	k r ɪ v ɔ m u
Розі	r ɔ z̪ʲ i
президенти	p r ɛ z̪ ɪ d̪ ɛ n̪ t̪ ɪ
принципом	p r ɪ n̪ t̪s̪ ɪ p ɔ m
наповнення	n̪ ɑ p ɔ v n̪ ɛ n̪ n̪ʲ ɑ
формування	f ɔ r m u v ɑ n̪ n̪ʲ ɑ
книга	k n̪ ɪ ɦ ɑ
А	ɑ
максимум	m ɑ k s̪ ɪ m u m
зусиль	z̪ u s̪ ɪ lʲ
села	s̪ ɛ l̪ ɑ
середньому	s̪ ɛ r ɛ d̪ n̪ʲ ɔ m u
місту	m i s̪ t̪ u
долю	d̪ ɔ lʲ u
однієї	ɔ d̪ n̪ʲ i ɛ j i
населених	n̪ ɑ s̪ ɛ l̪ ɛ n̪ ɪ x
пунктів	p u n̪ k t̪ i v
Карпо	k ɑ r p ɔ
стояв	s̪ t̪ ɔ ɑ v
дивився	d̪ ɪ v ɪ v s̪ ɑ
вплив	v p l̪ ɪ v
уряд	u rʲ ɑ d̪
подивитися	p ɔ d̪ ɪ v ɪ t̪ ɪ s̪ ɑ
бачать	b ɑ t̪ ʃ ɑ t̪
се	s̪ ɛ
твій	t̪ v i j
хліб	x lʲ i b
ніякої	n̪ʲ i ɑ k ɔ j i
справедливості	s̪ p r ɑ v ɛ d̪ l̪ ɪ v ɔ s̪ t̪ i
вистачило	v ɪ s̪ t̪ ɑ t̪ ʃ ɪ l̪ ɔ
моєї	m ɔ ɛ j i
постійної	p ɔ s̪ t̪ i j n̪ ɔ j i
уваги	u v ɑ ɦ ɪ
хочеться	x ɔ t̪ ʃ ɛ t̪ s̪ ɑ
розшуку	r ɔ z̪ ʃ u k u
жителів	ʒ ɪ t̪ ɛ lʲ i v
одного	ɔ d̪ n̪ ɔ ɦ ɔ
досить	d̪ ɔ s̪ ɪ t̪
оцінити	ɔ t̪s̪ʲ i n̪ ɪ t̪ ɪ
фестивалю	f ɛ s̪ t̪ ɪ v ɑ lʲ u
інструмент	i n̪ s̪ t̪ r u m ɛ n̪ t̪
культурної	k u lʲ t̪ u r n̪ ɔ j i
скасування	s̪ k ɑ s̪ u v ɑ n̪ n̪ʲ ɑ
візового	v i z̪ ɔ v ɔ ɦ ɔ
режиму	r ɛ ʒ ɪ m u
настав	n̪ ɑ s̪ t̪ ɑ v
рук	r u k
працювали	p r ɑ t̪s̪ʲ u v ɑ l̪ ɪ
такою	t̪ ɑ k ɔ u
якою	j ɑ k ɔ u
мрій	m rʲ i j
постає	p ɔ s̪ t̪ ɑ ɛ
довіри	d̪ ɔ v i r ɪ
громадян	ɦ r ɔ m ɑ d̪ʲ ɑ n̪
скажу	s̪ k ɑ ʒ u
одмовила	ɔ d̪ m ɔ v ɪ l̪ ɑ
нарозтяг	n̪ ɑ r ɔ z̪ t̪ ɑ ɦ
осміхаючись	ɔ s̪ m i x ɑ u t̪ ʃ ɪ s̪
коло	k ɔ l̪ ɔ
поля	p ɔ lʲ ɑ
хутором	x u t̪ ɔ r ɔ m
змін	z̪ m i n̪
колись	k ɔ l̪ ɪ s̪
Волині	v ɔ l̪ ɪ n̪ʲ i
стоять	s̪ t̪ ɔ ɑ t̪
пригоди	p r ɪ ɦ ɔ d̪ ɪ
вбивства	v b ɪ v s̪ t̪ v ɑ
пограбування	p ɔ ɦ r ɑ b u v ɑ n̪ n̪ʲ ɑ
борців	b ɔ r t̪s̪ʲ i v
его	ɛ ɦ ɔ
режисер	r ɛ ʒ ɪ s̪ ɛ r
наголосив	n̪ ɑ ɦ ɔ l̪ ɔ s̪ ɪ v
хочеш	x ɔ t̪ ʃ ɛ ʃ
експерти	ɛ k s̪ p ɛ r t̪ ɪ
вважає	v v ɑ ʒ ɑ ɛ
європейських	j ɛ v r ɔ p ɛ j s̪ k ɪ x
закінчився	z̪ ɑ k i n̪ t̪ ʃ ɪ v s̪ ɑ
імені	i m ɛ n̪ʲ i
внутрішні	v n̪ u t̪ rʲ i ʃ n̪ʲ i
обох	ɔ b ɔ x
Валентина	v ɑ l̪ ɛ n̪ t̪ ɪ n̪ ɑ
ким	k ɪ m
Ольги	ɔ lʲ ɦ ɪ
першою	p ɛ r ʃ ɔ u
дружиною	d̪ r u ʒ ɪ n̪ ɔ u
бачив	b ɑ t̪ ʃ ɪ v
бояться	b ɔ ɑ t̪ s̪ ɑ
шукають	ʃ u k ɑ u t̪
слави	s̪ l̪ ɑ v ɪ
можуть	m ɔ ʒ u t̪
яка	j ɑ k ɑ
комунальних	k ɔ m u n̪ ɑ lʲ n̪ ɪ x
дівчат	d̪ʲ i v t̪ ʃ ɑ t̪
особливого	ɔ s̪ ɔ b l̪ ɪ v ɔ ɦ ɔ
соціального	s̪ ɔ t̪s̪ʲ i ɑ lʲ n̪ ɔ ɦ ɔ
хлопчика	x l̪ ɔ p t̪ ʃ ɪ k ɑ
історичний	i s̪ t̪ ɔ r ɪ t̪ ʃ n̪ ɪ j
вистави	v ɪ s̪ t̪ ɑ v ɪ
перевірки	p ɛ r ɛ v i r k ɪ
показали	p ɔ k ɑ z̪ ɑ l̪ ɪ
вигідно	v ɪ ɦ i d̪ n̪ ɔ
вважав	v v ɑ ʒ ɑ v
білий	b i l̪ ɪ j
дощу	d̪ ɔ ʃ t̪ ʃ u
Грицьком	ɦ r ɪ t̪s̪ʲ k ɔ m
знати	z̪ n̪ ɑ t̪ ɪ
вино	v ɪ n̪ ɔ
фармацевта	f ɑ r m ɑ t̪s̪ ɛ v t̪ ɑ
обов'язково	ɔ b ɔ v j ɑ z̪ k ɔ v ɔ
пенсійного	p ɛ n̪ s̪ i j n̪ ɔ ɦ ɔ
віку	v i k u
зможе	z̪ m ɔ ʒ ɛ
зірки	z̪ʲ i r k ɪ
друзі	d̪ r u z̪ʲ i
невдовзі	n̪ ɛ v d̪ ɔ v z̪ʲ i
дай	d̪ ɑ j
боже	b ɔ ʒ ɛ
спішно	s̪ p i ʃ n̪ ɔ
відбулася	v i d̪ b u l̪ ɑ s̪ ɑ
виграти	v ɪ ɦ r ɑ t̪ ɪ
дорослих	d̪ ɔ r ɔ s̪ l̪ ɪ x
прийдеш	p r ɪ j d̪ ɛ ʃ
радянська	r ɑ d̪ʲ ɑ n̪ s̪ k ɑ
дала	d̪ ɑ l̪ ɑ
інформацію	i n̪ f ɔ r m ɑ t̪s̪ʲ i u
член	t̪ ʃ l̪ ɛ n̪
Національної	n̪ ɑ t̪s̪ʲ i ɔ n̪ ɑ lʲ n̪ ɔ j i
спілки	s̪ p i l̪ k ɪ
інтересах	i n̪ t̪ ɛ r ɛ s̪ ɑ x
руках	r u k ɑ x
генерального	ɦ ɛ n̪ ɛ r ɑ lʲ n̪ ɔ ɦ ɔ
прокурора	p r ɔ k u r ɔ r ɑ
світ	s̪ v i t̪
відтак	v i d̪ t̪ ɑ k
прокуратури	p r ɔ k u r ɑ t̪ u r ɪ
відповідне	v i d̪ p ɔ v i d̪ n̪ ɛ
клопотання	k l̪ ɔ p ɔ t̪ ɑ n̪ n̪ʲ ɑ
відмовився	v i d̪ m ɔ v ɪ v s̪ ɑ
яке	j ɑ k ɛ
йшлося	j ʃ l̪ ɔ s̪ ɑ
вище	v ɪ ʃ t̪ ʃ ɛ
МВФ	m v f
навряд	n̪ ɑ v rʲ ɑ d̪
Гонгадзе	ɦ ɔ n̪ ɦ ɑ d̪ z̪ ɛ
впоралися	v p ɔ r ɑ l̪ ɪ s̪ ɑ
історію	i s̪ t̪ ɔ rʲ i u
гурту	ɦ u r t̪ u
взяв	v z̪ʲ ɑ v
зрозумів	z̪ r ɔ z̪ u m i v
друге	d̪ r u ɦ ɛ
загрози	z̪ ɑ ɦ r ɔ z̪ ɪ
спрямовано	s̪ p rʲ ɑ m ɔ v ɑ n̪ ɔ
спроба	s̪ p r ɔ b ɑ
безпосередньо	b ɛ z̪ p ɔ s̪ ɛ r ɛ d̪ n̪ʲ ɔ
свідчать	s̪ v i d̪ t̪ ʃ ɑ t̪
тестування	t̪ ɛ s̪ t̪ u v ɑ n̪ n̪ʲ ɑ
Харкова	x ɑ r k ɔ v ɑ
громадських	ɦ r ɔ m ɑ d̪ s̪ k ɪ x
організацій	ɔ r ɦ ɑ n̪ʲ i z̪ ɑ t̪s̪ʲ i j
самий	s̪ ɑ m ɪ j
ситуацію	s̪ ɪ t̪ u ɑ t̪s̪ʲ i u
нових	n̪ ɔ v ɪ x
технологій	t̪ ɛ x n̪ ɔ l̪ ɔ ɦ i j
узявся	u z̪ʲ ɑ v s̪ ɑ
звідки	z̪ v i d̪ k ɪ
взявся	v z̪ʲ ɑ v s̪ ɑ
Мотрі	m ɔ t̪ rʲ i
хвалиться	x v ɑ l̪ ɪ t̪ s̪ ɑ
Тягнибок	t̪ ɑ ɦ n̪ ɪ b ɔ k
голос	ɦ ɔ l̪ ɔ s̪
думають	d̪ u m ɑ u t̪
Німеччина	n̪ʲ i m ɛ t̪ ʃ t̪ ʃ ɪ n̪ ɑ
дасть	d̪ ɑ s̪ t̪
підвищити	p i d̪ v ɪ ʃ t̪ ʃ ɪ t̪ ɪ
попит	p ɔ p ɪ t̪
житло	ʒ ɪ t̪ l̪ ɔ
постраждали	p ɔ s̪ t̪ r ɑ ʒ d̪ ɑ l̪ ɪ
їхніми	j i x n̪ʲ i m ɪ
даними	d̪ ɑ n̪ ɪ m ɪ
очікується	ɔ t̪ ʃ i k u ɛ t̪ s̪ ɑ
адміністрації	ɑ d̪ m i n̪ʲ i s̪ t̪ r ɑ t̪s̪ʲ i j i
заповідника	z̪ ɑ p ɔ v i d̪ n̪ ɪ k ɑ
стверджують	s̪ t̪ v ɛ r d̪ ʒ u u t̪
теми	t̪ ɛ m ɪ
кого	k ɔ ɦ ɔ
брати	b r ɑ t̪ ɪ
новим	n̪ ɔ v ɪ m
словом	s̪ l̪ ɔ v ɔ m
літературі	lʲ i t̪ ɛ r ɑ t̪ u rʲ i
Ізидора	i z̪ ɪ d̪ ɔ r ɑ
рідна	rʲ i d̪ n̪ ɑ
Українки	u k r ɑ j i n̪ k ɪ
відбулося	v i d̪ b u l̪ ɔ s̪ ɑ
українцями	u k r ɑ j i n̪ t̪s̪ʲ ɑ m ɪ
бази	b ɑ z̪ ɪ
районі	r ɑ j ɔ n̪ʲ i
змушує	z̪ m u ʃ u ɛ
чекати	t̪ ʃ ɛ k ɑ t̪ ɪ
разів	r ɑ z̪ʲ i v
торік	t̪ ɔ rʲ i k
їздив	j i z̪ d̪ ɪ v
старенький	s̪ t̪ ɑ r ɛ n̪ʲ k ɪ j
трамвай	t̪ r ɑ m v ɑ j
отримати	ɔ t̪ r ɪ m ɑ t̪ ɪ
контроль	k ɔ n̪ t̪ r ɔ lʲ
Київенерго	k ɪ j i v ɛ n̪ ɛ r ɦ ɔ
серпні	s̪ ɛ r p n̪ʲ i
виборів	v ɪ b ɔ rʲ i v
інциденту	i n̪ t̪s̪ ɪ d̪ ɛ n̪ t̪ u
хвороби	x v ɔ r ɔ b ɪ
мови	m ɔ v ɪ
запропонували	z̪ ɑ p r ɔ p ɔ n̪ u v ɑ l̪ ɪ
грати	ɦ r ɑ t̪ ɪ
народилася	n̪ ɑ r ɔ d̪ ɪ l̪ ɑ s̪ ɑ
квартири	k v ɑ r t̪ ɪ r ɪ
події	p ɔ d̪ʲ i j i
відновити	v i d̪ n̪ ɔ v ɪ t̪ ɪ
поховання	p ɔ x ɔ v ɑ n̪ n̪ʲ ɑ
батька	b ɑ t̪ k ɑ
сина	s̪ ɪ n̪ ɑ
щоби	ʃ t̪ ʃ ɔ b ɪ
Україну	u k r ɑ j i n̪ u
дружини	d̪ r u ʒ ɪ n̪ ɪ
Господь	ɦ ɔ s̪ p ɔ d̪ʲ
хмурнішав	x m u r n̪ʲ i ʃ ɑ v
попередньо	p ɔ p ɛ r ɛ d̪ n̪ʲ ɔ
відсоток	v i d̪ s̪ ɔ t̪ ɔ k
загибелі	z̪ ɑ ɦ ɪ b ɛ lʲ i
авто	ɑ v t̪ ɔ
мову	m ɔ v u
коріння	k ɔ rʲ i n̪ n̪ʲ ɑ
викликала	v ɪ k l̪ ɪ k ɑ l̪ ɑ
суспільстві	s̪ u s̪ p i lʲ s̪ t̪ v i
боротьба	b ɔ r ɔ t̪ b ɑ
вісімнадцяте	v i s̪ i m n̪ ɑ d̪ t̪s̪ʲ ɑ t̪ ɛ
о	ɔ
пів	p i v
сьому	s̪ ɔ m u
близько	b l̪ ɪ z̪ʲ k ɔ
гектарів	ɦ ɛ k t̪ ɑ rʲ i v
населення	n̪ ɑ s̪ ɛ l̪ ɛ n̪ n̪ʲ ɑ
порівнювати	p ɔ rʲ i v n̪ʲ u v ɑ t̪ ɪ
бали	b ɑ l̪ ɪ
підійшов	p i d̪ʲ i j ʃ ɔ v
правоохоронці	p r ɑ v ɔ ɔ x ɔ r ɔ n̪ t̪s̪ʲ i
власній	v l̪ ɑ s̪ n̪ʲ i j
оселі	ɔ s̪ ɛ lʲ i
знайшов	z̪ n̪ ɑ j ʃ ɔ v
пару	p ɑ r u
покоління	p ɔ k ɔ lʲ i n̪ n̪ʲ ɑ
віці	v i t̪s̪ʲ i
загальної	z̪ ɑ ɦ ɑ lʲ n̪ ɔ j i
отот	ɔ t̪ ɔ t̪
збирався	z̪ b ɪ r ɑ v s̪ ɑ
погаснути	p ɔ ɦ ɑ s̪ n̪ u t̪ ɪ
цить	t̪s̪ ɪ t̪
лапки	l̪ ɑ p k ɪ
поклали	p ɔ k l̪ ɑ l̪ ɪ
залишиться	z̪ ɑ l̪ ɪ ʃ ɪ t̪ s̪ ɑ
півтори	p i v t̪ ɔ r ɪ
захистити	z̪ ɑ x ɪ s̪ t̪ ɪ t̪ ɪ
стадіон	s̪ t̪ ɑ d̪ʲ i ɔ n̪
Дін	d̪ʲ i n̪
радянські	r ɑ d̪ʲ ɑ n̪ s̪ k i
договір	d̪ ɔ ɦ ɔ v i r
співпрацю	s̪ p i v p r ɑ t̪s̪ʲ u
ледве	l̪ ɛ d̪ v ɛ
ноги	n̪ ɔ ɦ ɪ
волочу	v ɔ l̪ ɔ t̪ ʃ u
піт	p i t̪
залива	z̪ ɑ l̪ ɪ v ɑ
самого	s̪ ɑ m ɔ ɦ ɔ
незалежності	n̪ ɛ z̪ ɑ l̪ ɛ ʒ n̪ ɔ s̪ t̪ i
найближчими	n̪ ɑ j b l̪ ɪ ʒ t̪ ʃ ɪ m ɪ
днями	d̪ n̪ʲ ɑ m ɪ
доведеться	d̪ ɔ v ɛ d̪ ɛ t̪ s̪ ɑ
дорозі	d̪ ɔ r ɔ z̪ʲ i
другого	d̪ r u ɦ ɔ ɦ ɔ
легендарного	l̪ ɛ ɦ ɛ n̪ d̪ ɑ r n̪ ɔ ɦ ɔ
одних	ɔ d̪ n̪ ɪ x
іншими	i n̪ ʃ ɪ m ɪ
явище	j ɑ v ɪ ʃ t̪ ʃ ɛ
природи	p r ɪ r ɔ d̪ ɪ
сила	s̪ ɪ l̪ ɑ
недурно	n̪ ɛ d̪ u r n̪ ɔ
сю	s̪ u
ніч	n̪ʲ i t̪ ʃ
собака	s̪ ɔ b ɑ k ɑ
снилася	s̪ n̪ ɪ l̪ ɑ s̪ ɑ
Європейського	j ɛ v r ɔ p ɛ j s̪ k ɔ ɦ ɔ
реконструкції	r ɛ k ɔ n̪ s̪ t̪ r u k t̪s̪ʲ i j i
попросив	p ɔ p r ɔ s̪ ɪ v
піти	p i t̪ ɪ
курсу	k u r s̪ u
ідеї	i d̪ ɛ j i
половиною	p ɔ l̪ ɔ v ɪ n̪ ɔ u
назад	n̪ ɑ z̪ ɑ d̪
передає	p ɛ r ɛ d̪ ɑ ɛ
УНІАН	u n̪ʲ i ɑ n̪
подарунок	p ɔ d̪ ɑ r u n̪ ɔ k
народження	n̪ ɑ r ɔ d̪ ʒ ɛ n̪ n̪ʲ ɑ
пригадував	p r ɪ ɦ ɑ d̪ u v ɑ v
знаємо	z̪ n̪ ɑ ɛ m ɔ
містах	m i s̪ t̪ ɑ x
надворі	n̪ ɑ d̪ v ɔ rʲ i
весна	v ɛ s̪ n̪ ɑ
вповні	v p ɔ v n̪ʲ i
прийшла	p r ɪ j ʃ l̪ ɑ
купівлю	k u p i v lʲ u
внутрішньої	v n̪ u t̪ rʲ i ʃ n̪ʲ ɔ j i
державної	d̪ ɛ r ʒ ɑ v n̪ ɔ j i
позики	p ɔ z̪ ɪ k ɪ
дітьми	d̪ʲ i t̪ m ɪ
порушення	p ɔ r u ʃ ɛ n̪ n̪ʲ ɑ
застосування	z̪ ɑ s̪ t̪ ɔ s̪ u v ɑ n̪ n̪ʲ ɑ
спрощеної	s̪ p r ɔ ʃ t̪ ʃ ɛ n̪ ɔ j i
оподаткування	ɔ p ɔ d̪ ɑ t̪ k u v ɑ n̪ n̪ʲ ɑ
Антарктиду	ɑ n̪ t̪ ɑ r k t̪ ɪ d̪ u
боротьбі	b ɔ r ɔ t̪ b i
корупцією	k ɔ r u p t̪s̪ʲ i ɛ u
їхня	j i x n̪ʲ ɑ
позиція	p ɔ z̪ ɪ t̪s̪ʲ i ɑ
дорога	d̪ ɔ r ɔ ɦ ɑ
храму	x r ɑ m u
почала	p ɔ t̪ ʃ ɑ l̪ ɑ
Оксана	ɔ k s̪ ɑ n̪ ɑ
купує	k u p u ɛ
вирішувати	v ɪ rʲ i ʃ u v ɑ t̪ ɪ
здебільшого	z̪ d̪ ɛ b i lʲ ʃ ɔ ɦ ɔ
Ющенко	j u ʃ t̪ ʃ ɛ n̪ k ɔ
світові	s̪ v i t̪ ɔ v i
прем'єри	p r ɛ m j ɛ r ɪ
грудях	ɦ r u d̪ʲ ɑ x
сказавсь	s̪ k ɑ z̪ ɑ v s̪
біс	b i s̪
зна	z̪ n̪ ɑ
українець	u k r ɑ j i n̪ ɛ t̪s̪ʲ
знання	z̪ n̪ ɑ n̪ n̪ʲ ɑ
читати	t̪ ʃ ɪ t̪ ɑ t̪ ɪ
пряли	p rʲ ɑ l̪ ɪ
вийшов	v ɪ j ʃ ɔ v
захищати	z̪ ɑ x ɪ ʃ t̪ ʃ ɑ t̪ ɪ
впливати	v p l̪ ɪ v ɑ t̪ ɪ
візьму	v i z̪ʲ m u
жінку	ʒ i n̪ k u
поблизу	p ɔ b l̪ ɪ z̪ u
кордонів	k ɔ r d̪ ɔ n̪ʲ i v
доньку	d̪ ɔ n̪ʲ k u
відразу	v i d̪ r ɑ z̪ u
позов	p ɔ z̪ ɔ v
нудьга	n̪ u d̪ʲ ɦ ɑ
виглядати	v ɪ ɦ lʲ ɑ d̪ ɑ t̪ ɪ
очима	ɔ t̪ ʃ ɪ m ɑ
нагадує	n̪ ɑ ɦ ɑ d̪ u ɛ
стіни	s̪ t̪ i n̪ ɪ
чули	t̪ ʃ u l̪ ɪ
третій	t̪ r ɛ t̪ i j
слава	s̪ l̪ ɑ v ɑ
годину	ɦ ɔ d̪ ɪ n̪ u
дитину	d̪ ɪ t̪ ɪ n̪ u
бачить	b ɑ t̪ ʃ ɪ t̪
між	m i ʒ
обрали	ɔ b r ɑ l̪ ɪ
спроби	s̪ p r ɔ b ɪ
їздити	j i z̪ d̪ ɪ t̪ ɪ
селах	s̪ ɛ l̪ ɑ x
порушила	p ɔ r u ʃ ɪ l̪ ɑ
чекають	t̪ ʃ ɛ k ɑ u t̪
відповіді	v i d̪ p ɔ v i d̪ʲ i
столиці	s̪ t̪ ɔ l̪ ɪ t̪s̪ʲ i
решта	r ɛ ʃ t̪ ɑ
традиційно	t̪ r ɑ d̪ ɪ t̪s̪ʲ i j n̪ ɔ
матиме	m ɑ t̪ ɪ m ɛ
шестеро	ʃ ɛ s̪ t̪ ɛ r ɔ
пропонуємо	p r ɔ p ɔ n̪ u ɛ m ɔ
частину	t̪ ʃ ɑ s̪ t̪ ɪ n̪ u
Спілці	s̪ p i l̪ t̪s̪ʲ i
плани	p l̪ ɑ n̪ ɪ
модернізувати	m ɔ d̪ ɛ r n̪ʲ i z̪ u v ɑ t̪ ɪ
підтримав	p i d̪ t̪ r ɪ m ɑ v
ідею	i d̪ ɛ u
згадаю	z̪ ɦ ɑ d̪ ɑ u
прохолодних	p r ɔ x ɔ l̪ ɔ d̪ n̪ ɪ x
озер	ɔ z̪ ɛ r
блакить	b l̪ ɑ k ɪ t̪
Харкові	x ɑ r k ɔ v i
Запоріжжі	z̪ ɑ p ɔ rʲ i ʒ ʒ i
тій	t̪ i j
Луганщині	l̪ u ɦ ɑ n̪ ʃ t̪ ʃ ɪ n̪ʲ i
жодних	ʒ ɔ d̪ n̪ ɪ x
структур	s̪ t̪ r u k t̪ u r
ваші	v ɑ ʃ i
книжки	k n̪ ɪ ʒ k ɪ
почалася	p ɔ t̪ ʃ ɑ l̪ ɑ s̪ ɑ
період	p ɛ rʲ i ɔ d̪
президентських	p r ɛ z̪ ɪ d̪ ɛ n̪ t̪ s̪ k ɪ x
візиту	v i z̪ ɪ t̪ u
якого	j ɑ k ɔ ɦ ɔ
чудово	t̪ ʃ u d̪ ɔ v ɔ
ту	t̪ u
славу	s̪ l̪ ɑ v u
чітко	t̪ ʃ i t̪ k ɔ
передбачає	p ɛ r ɛ d̪ b ɑ t̪ ʃ ɑ ɛ
померла	p ɔ m ɛ r l̪ ɑ
ставить	s̪ t̪ ɑ v ɪ t̪
вимагають	v ɪ m ɑ ɦ ɑ u t̪
впливу	v p l̪ ɪ v u
групи	ɦ r u p ɪ
рефінансування	r ɛ f i n̪ ɑ n̪ s̪ u v ɑ n̪ n̪ʲ ɑ
книжок	k n̪ ɪ ʒ ɔ k
процеси	p r ɔ t̪s̪ ɛ s̪ ɪ
складі	s̪ k l̪ ɑ d̪ʲ i
пакет	p ɑ k ɛ t̪
самої	s̪ ɑ m ɔ j i
поранений	p ɔ r ɑ n̪ ɛ n̪ ɪ j
візьміть	v i z̪ʲ m i t̪
пара	p ɑ r ɑ
вдасться	v d̪ ɑ s̪ t̪ s̪ ɑ
затримали	z̪ ɑ t̪ r ɪ m ɑ l̪ ɪ
правила	p r ɑ v ɪ l̪ ɑ
заяви	z̪ ɑ ɑ v ɪ
регіонах	r ɛ ɦ i ɔ n̪ ɑ x
вулицю	v u l̪ ɪ t̪s̪ʲ u
звучить	z̪ v u t̪ ʃ ɪ t̪
проблемні	p r ɔ b l̪ ɛ m n̪ʲ i
кредити	k r ɛ d̪ ɪ t̪ ɪ
показують	p ɔ k ɑ z̪ u u t̪
півроку	p i v r ɔ k u
дорожче	d̪ ɔ r ɔ ʒ t̪ ʃ ɛ
задоволення	z̪ ɑ d̪ ɔ v ɔ l̪ ɛ n̪ n̪ʲ ɑ
розуміє	r ɔ z̪ u m i ɛ
українофіли	u k r ɑ j i n̪ ɔ f i l̪ ɪ
наступний	n̪ ɑ s̪ t̪ u p n̪ ɪ j
додаткових	d̪ ɔ d̪ ɑ t̪ k ɔ v ɪ x
передбачено	p ɛ r ɛ d̪ b ɑ t̪ ʃ ɛ n̪ ɔ
миру	m ɪ r u
ладу	l̪ ɑ d̪ u
сестрою	s̪ ɛ s̪ t̪ r ɔ u
гірше	ɦ i r ʃ ɛ
Дніпропетровську	d̪ n̪ʲ i p r ɔ p ɛ t̪ r ɔ v s̪ k u
регіонів	r ɛ ɦ i ɔ n̪ʲ i v
грн	ɦ r n̪
запасів	z̪ ɑ p ɑ s̪ i v
перевищує	p ɛ r ɛ v ɪ ʃ t̪ ʃ u ɛ
змінилося	z̪ m i n̪ ɪ l̪ ɔ s̪ ɑ
приїхали	p r ɪ j i x ɑ l̪ ɪ
Західної	z̪ ɑ x i d̪ n̪ ɔ j i
достатньо	d̪ ɔ s̪ t̪ ɑ t̪ n̪ʲ ɔ
намагається	n̪ ɑ m ɑ ɦ ɑ ɛ t̪ s̪ ɑ
спільну	s̪ p i lʲ n̪ u
документ	d̪ ɔ k u m ɛ n̪ t̪
лідерів	lʲ i d̪ ɛ rʲ i v
заходи	z̪ ɑ x ɔ d̪ ɪ
шоу	ʃ ɔ u
місцеві	m i s̪ t̪s̪ ɛ v i
виходити	v ɪ x ɔ d̪ ɪ t̪ ɪ
вами	v ɑ m ɪ
свят	s̪ v ɑ t̪
Дня	d̪ n̪ʲ ɑ
Перемоги	p ɛ r ɛ m ɔ ɦ ɪ
помилку	p ɔ m ɪ l̪ k u
олігархи	ɔ lʲ i ɦ ɑ r x ɪ
справи	s̪ p r ɑ v ɪ
написати	n̪ ɑ p ɪ s̪ ɑ t̪ ɪ
роман	r ɔ m ɑ n̪
щойно	ʃ t̪ ʃ ɔ j n̪ ɔ
зустрів	z̪ u s̪ t̪ rʲ i v
біг	b i ɦ
академії	ɑ k ɑ d̪ ɛ m i j i
наук	n̪ ɑ u k
США	s̪ ʃ ɑ
Польща	p ɔ lʲ ʃ t̪ ʃ ɑ
обіцяють	ɔ b i t̪s̪ʲ ɑ u t̪
безкоштовно	b ɛ z̪ k ɔ ʃ t̪ ɔ v n̪ ɔ
форум	f ɔ r u m
пройшов	p r ɔ j ʃ ɔ v
доволі	d̪ ɔ v ɔ lʲ i
всередині	v s̪ ɛ r ɛ d̪ ɪ n̪ʲ i
визнання	v ɪ z̪ n̪ ɑ n̪ n̪ʲ ɑ
ліга	lʲ i ɦ ɑ
війні	v i j n̪ʲ i
позирав	p ɔ z̪ ɪ r ɑ v
хижо	x ɪ ʒ ɔ
думав	d̪ u m ɑ v
студентів	s̪ t̪ u d̪ ɛ n̪ t̪ i v
Грузії	ɦ r u z̪ʲ i j i
акції	ɑ k t̪s̪ʲ i j i
значною	z̪ n̪ ɑ t̪ ʃ n̪ ɔ u
мірою	m i r ɔ u
досягли	d̪ ɔ s̪ ɑ ɦ l̪ ɪ
дитино	d̪ ɪ t̪ ɪ n̪ ɔ
казали	k ɑ z̪ ɑ l̪ ɪ
либонь	l̪ ɪ b ɔ n̪ʲ
умерла	u m ɛ r l̪ ɑ
чутно	t̪ ʃ u t̪ n̪ ɔ
дух	d̪ u x
спира	s̪ p ɪ r ɑ
од	ɔ d̪
начебто	n̪ ɑ t̪ ʃ ɛ b t̪ ɔ
приємно	p r ɪ ɛ m n̪ ɔ
пішло	p i ʃ l̪ ɔ
проходили	p r ɔ x ɔ d̪ ɪ l̪ ɪ
змінювати	z̪ m i n̪ʲ u v ɑ t̪ ɪ
Конституцію	k ɔ n̪ s̪ t̪ ɪ t̪ u t̪s̪ʲ i u
відрізняється	v i d̪ rʲ i z̪ n̪ʲ ɑ ɛ t̪ s̪ ɑ
вузів	v u z̪ʲ i v
напрямку	n̪ ɑ p rʲ ɑ m k u
угоди	u ɦ ɔ d̪ ɪ
СОТ	s̪ ɔ t̪
Євген	j ɛ v ɦ ɛ n̪
Коновалець	k ɔ n̪ ɔ v ɑ l̪ ɛ t̪s̪ʲ
роках	r ɔ k ɑ x
особливу	ɔ s̪ ɔ b l̪ ɪ v u
атмосферу	ɑ t̪ m ɔ s̪ f ɛ r u
гори	ɦ ɔ r ɪ
попередній	p ɔ p ɛ r ɛ d̪ n̪ʲ i j
ласкаво	l̪ ɑ s̪ k ɑ v ɔ
одказав	ɔ d̪ k ɑ z̪ ɑ v
цікавих	t̪s̪ʲ i k ɑ v ɪ x
робіт	r ɔ b i t̪
Лаврін	l̪ ɑ v rʲ i n̪
заплатить	z̪ ɑ p l̪ ɑ t̪ ɪ t̪
прокуратурі	p r ɔ k u r ɑ t̪ u rʲ i
свідчення	s̪ v i d̪ t̪ ʃ ɛ n̪ n̪ʲ ɑ
діда	d̪ʲ i d̪ ɑ
регіонального	r ɛ ɦ i ɔ n̪ ɑ lʲ n̪ ɔ ɦ ɔ
Тихонов	t̪ ɪ x ɔ n̪ ɔ v
могли	m ɔ ɦ l̪ ɪ
затримати	z̪ ɑ t̪ r ɪ m ɑ t̪ ɪ
щодня	ʃ t̪ ʃ ɔ d̪ n̪ʲ ɑ
хвилина	x v ɪ l̪ ɪ n̪ ɑ
жита	ʒ ɪ t̪ ɑ
заманячила	z̪ ɑ m ɑ n̪ʲ ɑ t̪ ʃ ɪ l̪ ɑ
дівоча	d̪ʲ i v ɔ t̪ ʃ ɑ
постать	p ɔ s̪ t̪ ɑ t̪
відчувають	v i d̪ t̪ ʃ u v ɑ u t̪
такими	t̪ ɑ k ɪ m ɪ
середа	s̪ ɛ r ɛ d̪ ɑ
Херсоні	x ɛ r s̪ ɔ n̪ʲ i
вісім	v i s̪ i m
знімати	z̪ n̪ʲ i m ɑ t̪ ɪ
перші	p ɛ r ʃ i
кроки	k r ɔ k ɪ
намір	n̪ ɑ m i r
обмежити	ɔ b m ɛ ʒ ɪ t̪ ɪ
випадок	v ɪ p ɑ d̪ ɔ k
парламенті	p ɑ r l̪ ɑ m ɛ n̪ t̪ i
очолював	ɔ t̪ ʃ ɔ lʲ u v ɑ v
опозицію	ɔ p ɔ z̪ ɪ t̪s̪ʲ i u
Народної	n̪ ɑ r ɔ d̪ n̪ ɔ j i
візьме	v i z̪ʲ m ɛ
Державному	d̪ ɛ r ʒ ɑ v n̪ ɔ m u
космічному	k ɔ s̪ m i t̪ ʃ n̪ ɔ m u
агентству	ɑ ɦ ɛ n̪ t̪ s̪ t̪ v u
виповнюється	v ɪ p ɔ v n̪ʲ u ɛ t̪ s̪ ɑ
годин	ɦ ɔ d̪ ɪ n̪
слідчі	s̪ lʲ i d̪ t̪ ʃ i
розпочали	r ɔ z̪ p ɔ t̪ ʃ ɑ l̪ ɪ
звернулася	z̪ v ɛ r n̪ u l̪ ɑ s̪ ɑ
зміг	z̪ m i ɦ
наважувався	n̪ ɑ v ɑ ʒ u v ɑ v s̪ ɑ
тарифів	t̪ ɑ r ɪ f i v
послуги	p ɔ s̪ l̪ u ɦ ɪ
Кабміну	k ɑ b m i n̪ u
приїхати	p r ɪ j i x ɑ t̪ ɪ
Сум	s̪ u m
Литвин	l̪ ɪ t̪ v ɪ n̪
століття	s̪ t̪ ɔ lʲ i t̪ t̪ ɑ
Одеса	ɔ d̪ ɛ s̪ ɑ
Львів	lʲ v i v
лідери	lʲ i d̪ ɛ r ɪ
житла	ʒ ɪ t̪ l̪ ɑ
вина	v ɪ n̪ ɑ
правду	p r ɑ v d̪ u
Тим	t̪ ɪ m
промовив	p r ɔ m ɔ v ɪ v
уголос	u ɦ ɔ l̪ ɔ s̪
потрапив	p ɔ t̪ r ɑ p ɪ v
лікарню	lʲ i k ɑ r n̪ʲ u
ввечері	v v ɛ t̪ ʃ ɛ rʲ i
перевела	p ɛ r ɛ v ɛ l̪ ɑ
озирнулася	ɔ z̪ ɪ r n̪ u l̪ ɑ s̪ ɑ
КДБ	k d̪ b
самотужки	s̪ ɑ m ɔ t̪ u ʒ k ɪ
повернулася	p ɔ v ɛ r n̪ u l̪ ɑ s̪ ɑ
ініціатива	i n̪ʲ i t̪s̪ʲ i ɑ t̪ ɪ v ɑ
тиску	t̪ ɪ s̪ k u
громадської	ɦ r ɔ m ɑ d̪ s̪ k ɔ j i
питанням	p ɪ t̪ ɑ n̪ n̪ʲ ɑ m
працюємо	p r ɑ t̪s̪ʲ u ɛ m ɔ
реальних	r ɛ ɑ lʲ n̪ ɪ x
хати	x ɑ t̪ ɪ
віником	v i n̪ ɪ k ɔ m
обмела	ɔ b m ɛ l̪ ɑ
лишилось	l̪ ɪ ʃ ɪ l̪ ɔ s̪
десять	d̪ ɛ s̪ ɑ t̪
колективу	k ɔ l̪ ɛ k t̪ ɪ v u
редакції	r ɛ d̪ ɑ k t̪s̪ʲ i j i
подарував	p ɔ d̪ ɑ r u v ɑ v
підстави	p i d̪ s̪ t̪ ɑ v ɪ
знайти	z̪ n̪ ɑ j t̪ ɪ
означає	ɔ z̪ n̪ ɑ t̪ ʃ ɑ ɛ
повинен	p ɔ v ɪ n̪ ɛ n̪
відставку	v i d̪ s̪ t̪ ɑ v k u
нагадують	n̪ ɑ ɦ ɑ d̪ u u t̪
ефірі	ɛ f i rʲ i
телеканалу	t̪ ɛ l̪ ɛ k ɑ n̪ ɑ l̪ u
ТВІ	t̪ v i
шляху	ʃ lʲ ɑ x u
капіталізації	k ɑ p i t̪ ɑ lʲ i z̪ ɑ t̪s̪ʲ i j i
Нафтогазу	n̪ ɑ f t̪ ɔ ɦ ɑ z̪ u
Заслужений	z̪ ɑ s̪ l̪ u ʒ ɛ n̪ ɪ j
майстер	m ɑ j s̪ t̪ ɛ r
тренер	t̪ r ɛ n̪ ɛ r
фінансової	f i n̪ ɑ n̪ s̪ ɔ v ɔ j i
тижні	t̪ ɪ ʒ n̪ʲ i
повінчали	p ɔ v i n̪ t̪ ʃ ɑ l̪ ɪ
необхідні	n̪ ɛ ɔ b x i d̪ n̪ʲ i
дії	d̪ʲ i j i
зросла	z̪ r ɔ s̪ l̪ ɑ
кріпаки	k rʲ i p ɑ k ɪ
міф	m i f
будинків	b u d̪ ɪ n̪ k i v
приніс	p r ɪ n̪ʲ i s̪
іноземних	i n̪ ɔ z̪ ɛ m n̪ ɪ x
стати	s̪ t̪ ɑ t̪ ɪ
центром	t̪s̪ ɛ n̪ t̪ r ɔ m
сучасних	s̪ u t̪ ʃ ɑ s̪ n̪ ɪ x
готується	ɦ ɔ t̪ u ɛ t̪ s̪ ɑ
читання	t̪ ʃ ɪ t̪ ɑ n̪ n̪ʲ ɑ
Шухевича	ʃ u x ɛ v ɪ t̪ ʃ ɑ
реєстрацію	r ɛ ɛ s̪ t̪ r ɑ t̪s̪ʲ i u
задивився	z̪ ɑ d̪ ɪ v ɪ v s̪ ɑ
хутір	x u t̪ i r
заяву	z̪ ɑ ɑ v u
звільнення	z̪ v i lʲ n̪ ɛ n̪ n̪ʲ ɑ
напали	n̪ ɑ p ɑ l̪ ɪ
цілих	t̪s̪ʲ i l̪ ɪ x
сплачувати	s̪ p l̪ ɑ t̪ ʃ u v ɑ t̪ ɪ
гарячих	ɦ ɑ rʲ ɑ t̪ ʃ ɪ x
здоров	z̪ d̪ ɔ r ɔ v
складні	s̪ k l̪ ɑ d̪ n̪ʲ i
шлях	ʃ lʲ ɑ x
Юрій	j u rʲ i j
Луценко	l̪ u t̪s̪ ɛ n̪ k ɔ
міністр	m i n̪ʲ i s̪ t̪ r
внутрішніх	v n̪ u t̪ rʲ i ʃ n̪ʲ i x
активісти	ɑ k t̪ ɪ v i s̪ t̪ ɪ
дістатися	d̪ʲ i s̪ t̪ ɑ t̪ ɪ s̪ ɑ
Полтави	p ɔ l̪ t̪ ɑ v ɪ
Януковича	j ɑ n̪ u k ɔ v ɪ t̪ ʃ ɑ
дев'ятий	d̪ ɛ v j ɑ t̪ ɪ j
запам'ятається	z̪ ɑ p ɑ m j ɑ t̪ ɑ ɛ t̪ s̪ ɑ
надовго	n̪ ɑ d̪ ɔ v ɦ ɔ
вірьовкою	v i rʲ ɔ v k ɔ u
навхрест	n̪ ɑ v x r ɛ s̪ t̪
перев'язана	p ɛ r ɛ v j ɑ z̪ ɑ n̪ ɑ
одежа	ɔ d̪ ɛ ʒ ɑ
Януковичу	j ɑ n̪ u k ɔ v ɪ t̪ ʃ u
туристів	t̪ u r ɪ s̪ t̪ i v
реклами	r ɛ k l̪ ɑ m ɪ
неподалік	n̪ ɛ p ɔ d̪ ɑ lʲ i k
передовсім	p ɛ r ɛ d̪ ɔ v s̪ i m
представник	p r ɛ d̪ s̪ t̪ ɑ v n̪ ɪ k
операція	ɔ p ɛ r ɑ t̪s̪ʲ i ɑ
Німеччині	n̪ʲ i m ɛ t̪ ʃ t̪ ʃ ɪ n̪ʲ i
назавжди	n̪ ɑ z̪ ɑ v ʒ d̪ ɪ
визнати	v ɪ z̪ n̪ ɑ t̪ ɪ
Бердянська	b ɛ r d̪ʲ ɑ n̪ s̪ k ɑ
тварини	t̪ v ɑ r ɪ n̪ ɪ
проекти	p r ɔ ɛ k t̪ ɪ
підтримує	p i d̪ t̪ r ɪ m u ɛ
останнім	ɔ s̪ t̪ ɑ n̪ n̪ʲ i m
господарстві	ɦ ɔ s̪ p ɔ d̪ ɑ r s̪ t̪ v i
власну	v l̪ ɑ s̪ n̪ u
творчість	t̪ v ɔ r t̪ ʃ i s̪ t̪
команді	k ɔ m ɑ n̪ d̪ʲ i
іншій	i n̪ ʃ i j
лідер	lʲ i d̪ ɛ r
БЮТ	b u t̪
березі	b ɛ r ɛ z̪ʲ i
власність	v l̪ ɑ s̪ n̪ʲ i s̪ t̪
територіальної	t̪ ɛ r ɪ t̪ ɔ rʲ i ɑ lʲ n̪ ɔ j i
громади	ɦ r ɔ m ɑ d̪ ɪ
залежатиме	z̪ ɑ l̪ ɛ ʒ ɑ t̪ ɪ m ɛ
Віталій	v i t̪ ɑ lʲ i j
студент	s̪ t̪ u d̪ ɛ n̪ t̪
історичного	i s̪ t̪ ɔ r ɪ t̪ ʃ n̪ ɔ ɦ ɔ
факультету	f ɑ k u lʲ t̪ ɛ t̪ u
чолі	t̪ ʃ ɔ lʲ i
опинилася	ɔ p ɪ n̪ ɪ l̪ ɑ s̪ ɑ
довгий	d̪ ɔ v ɦ ɪ j
працював	p r ɑ t̪s̪ʲ u v ɑ v
просять	p r ɔ s̪ ɑ t̪
центральних	t̪s̪ ɛ n̪ t̪ r ɑ lʲ n̪ ɪ x
районів	r ɑ j ɔ n̪ʲ i v
СІЗО	s̪ i z̪ ɔ
пошуку	p ɔ ʃ u k u
дочка	d̪ ɔ t̪ ʃ k ɑ
двоє	d̪ v ɔ ɛ
сто	s̪ t̪ ɔ
Хортиці	x ɔ r t̪ ɪ t̪s̪ʲ i
порушили	p ɔ r u ʃ ɪ l̪ ɪ
Бразилії	b r ɑ z̪ ɪ lʲ i j i
розбився	r ɔ z̪ b ɪ v s̪ ɑ
пасажирський	p ɑ s̪ ɑ ʒ ɪ r s̪ k ɪ j
літак	lʲ i t̪ ɑ k
героїв	ɦ ɛ r ɔ j i v
подали	p ɔ d̪ ɑ l̪ ɪ
шанс	ʃ ɑ n̪ s̪
допустити	d̪ ɔ p u s̪ t̪ ɪ t̪ ɪ
новий	n̪ ɔ v ɪ j
керівником	k ɛ rʲ i v n̪ ɪ k ɔ m
досягнення	d̪ ɔ s̪ ɑ ɦ n̪ ɛ n̪ n̪ʲ ɑ
менш	m ɛ n̪ ʃ
вікна	v i k n̪ ɑ
напад	n̪ ɑ p ɑ d̪
організувати	ɔ r ɦ ɑ n̪ʲ i z̪ u v ɑ t̪ ɪ
традиції	t̪ r ɑ d̪ ɪ t̪s̪ʲ i j i
відмовитися	v i d̪ m ɔ v ɪ t̪ ɪ s̪ ɑ
грає	ɦ r ɑ ɛ
займатися	z̪ ɑ j m ɑ t̪ ɪ s̪ ɑ
значний	z̪ n̪ ɑ t̪ ʃ n̪ ɪ j
економічний	ɛ k ɔ n̪ ɔ m i t̪ ʃ n̪ ɪ j
ефект	ɛ f ɛ k t̪
лад	l̪ ɑ d̪
ворота	v ɔ r ɔ t̪ ɑ
побиті	p ɔ b ɪ t̪ i
лежали	l̪ ɛ ʒ ɑ l̪ ɪ
процесу	p r ɔ t̪s̪ ɛ s̪ u
систему	s̪ ɪ s̪ t̪ ɛ m u
гарант	ɦ ɑ r ɑ n̪ t̪
підкреслив	p i d̪ k r ɛ s̪ l̪ ɪ v
навіщо	n̪ ɑ v i ʃ t̪ ʃ ɔ
займалися	z̪ ɑ j m ɑ l̪ ɪ s̪ ɑ
вимоги	v ɪ m ɔ ɦ ɪ
ринок	r ɪ n̪ ɔ k
виникає	v ɪ n̪ ɪ k ɑ ɛ
Зоря	z̪ ɔ rʲ ɑ
матчу	m ɑ t̪ t̪ ʃ u
Карпатами	k ɑ r p ɑ t̪ ɑ m ɪ
сході	s̪ x ɔ d̪ʲ i
заході	z̪ ɑ x ɔ d̪ʲ i
пенсійний	p ɛ n̪ s̪ i j n̪ ɪ j
вік	v i k
телебачення	t̪ ɛ l̪ ɛ b ɑ t̪ ʃ ɛ n̪ n̪ʲ ɑ
прокуратура	p r ɔ k u r ɑ t̪ u r ɑ
більш	b i lʲ ʃ
зуби	z̪ u b ɪ
сильно	s̪ ɪ lʲ n̪ ɔ
стиснувши	s̪ t̪ ɪ s̪ n̪ u v ʃ ɪ
маму	m ɑ m u
ніжно	n̪ʲ i ʒ n̪ ɔ
любити	lʲ u b ɪ t̪ ɪ
чепурить	t̪ ʃ ɛ p u r ɪ t̪
прибира	p r ɪ b ɪ r ɑ
ставлення	s̪ t̪ ɑ v l̪ ɛ n̪ n̪ʲ ɑ
передусім	p ɛ r ɛ d̪ u s̪ i m
фотовиставка	f ɔ t̪ ɔ v ɪ s̪ t̪ ɑ v k ɑ
вступав	v s̪ t̪ u p ɑ v
якийсь	j ɑ k ɪ j s̪
невідомий	n̪ ɛ v i d̪ ɔ m ɪ j
столиця	s̪ t̪ ɔ l̪ ɪ t̪s̪ʲ ɑ
постанову	p ɔ s̪ t̪ ɑ n̪ ɔ v u
голосувати	ɦ ɔ l̪ ɔ s̪ u v ɑ t̪ ɪ
відносин	v i d̪ n̪ ɔ s̪ ɪ n̪
ризики	r ɪ z̪ ɪ k ɪ
вибухів	v ɪ b u x i v
загинуло	z̪ ɑ ɦ ɪ n̪ u l̪ ɔ
помітили	p ɔ m i t̪ ɪ l̪ ɪ
шкур	ʃ k u r
вовчих	v ɔ v t̪ ʃ ɪ x
приймати	p r ɪ j m ɑ t̪ ɪ
контексті	k ɔ n̪ t̪ ɛ k s̪ t̪ i
керівник	k ɛ rʲ i v n̪ ɪ k
громадяни	ɦ r ɔ m ɑ d̪ʲ ɑ n̪ ɪ
підсумки	p i d̪ s̪ u m k ɪ
сільськогосподарського	s̪ i lʲ s̪ k ɔ ɦ ɔ s̪ p ɔ d̪ ɑ r s̪ k ɔ ɦ ɔ
Руслана	r u s̪ l̪ ɑ n̪ ɑ
міській	m i s̪ k i j
раді	r ɑ d̪ʲ i
можливих	m ɔ ʒ l̪ ɪ v ɪ x
розглянув	r ɔ z̪ ɦ lʲ ɑ n̪ u v
помилування	p ɔ m ɪ l̪ u v ɑ n̪ n̪ʲ ɑ
упродовж	u p r ɔ d̪ ɔ v ʒ
філії	f i lʲ i j i
робочі	r ɔ b ɔ t̪ ʃ i
трохи	t̪ r ɔ x ɪ
добровільно	d̪ ɔ b r ɔ v i lʲ n̪ ɔ
видали	v ɪ d̪ ɑ l̪ ɪ
вимагали	v ɪ m ɑ ɦ ɑ l̪ ɪ
одинадцяте	ɔ d̪ ɪ n̪ ɑ d̪ t̪s̪ʲ ɑ t̪ ɛ
листопада	l̪ ɪ s̪ t̪ ɔ p ɑ d̪ ɑ
п'ятдесят	p j ɑ t̪ d̪ ɛ s̪ ɑ t̪
перспективу	p ɛ r s̪ p ɛ k t̪ ɪ v u
будьякій	b u d̪ʲ ɑ k i j
заступник	z̪ ɑ s̪ t̪ u p n̪ ɪ k
податкової	p ɔ d̪ ɑ t̪ k ɔ v ɔ j i
великої	v ɛ l̪ ɪ k ɔ j i
схожий	s̪ x ɔ ʒ ɪ j
дійство	d̪ʲ i j s̪ t̪ v ɔ
музики	m u z̪ ɪ k ɪ
поезії	p ɔ ɛ z̪ʲ i j i
співати	s̪ p i v ɑ t̪ ɪ
плакати	p l̪ ɑ k ɑ t̪ ɪ
губернатор	ɦ u b ɛ r n̪ ɑ t̪ ɔ r
голови	ɦ ɔ l̪ ɔ v ɪ
дійшла	d̪ʲ i j ʃ l̪ ɑ
паче	p ɑ t̪ ʃ ɛ
знадний	z̪ n̪ ɑ d̪ n̪ ɪ j
усмішкою	u s̪ m i ʃ k ɔ u
вимагав	v ɪ m ɑ ɦ ɑ v
писала	p ɪ s̪ ɑ l̪ ɑ
Михайлина	m ɪ x ɑ j l̪ ɪ n̪ ɑ
Хомівна	x ɔ m i v n̪ ɑ
єдина	j ɛ d̪ ɪ n̪ ɑ
церква	t̪s̪ ɛ r k v ɑ
розташована	r ɔ z̪ t̪ ɑ ʃ ɔ v ɑ n̪ ɑ
поряд	p ɔ rʲ ɑ d̪
державним	d̪ ɛ r ʒ ɑ v n̪ ɪ m
ВНЗ	v n̪ z̪
жив	ʒ ɪ v
поїхати	p ɔ j i x ɑ t̪ ɪ
допомоги	d̪ ɔ p ɔ m ɔ ɦ ɪ
ваш	v ɑ ʃ
ведення	v ɛ d̪ ɛ n̪ n̪ʲ ɑ
щоденника	ʃ t̪ ʃ ɔ d̪ ɛ n̪ n̪ ɪ k ɑ
перевірка	p ɛ r ɛ v i r k ɑ
вискочила	v ɪ s̪ k ɔ t̪ ʃ ɪ l̪ ɑ
зелену	z̪ ɛ l̪ ɛ n̪ u
луку	l̪ u k u
збираються	z̪ b ɪ r ɑ u t̪ s̪ ɑ
мамо	m ɑ m ɔ
знаєте	z̪ n̪ ɑ ɛ t̪ ɛ
москаля	m ɔ s̪ k ɑ lʲ ɑ
робочий	r ɔ b ɔ t̪ ʃ ɪ j
Фронту	f r ɔ n̪ t̪ u
сусідів	s̪ u s̪ i d̪ʲ i v
гукнула	ɦ u k n̪ u l̪ ɑ
тин	t̪ ɪ n̪
Кайдашихи	k ɑ j d̪ ɑ ʃ ɪ x ɪ
досвіду	d̪ ɔ s̪ v i d̪ u
університетах	u n̪ʲ i v ɛ r s̪ ɪ t̪ ɛ t̪ ɑ x
щотижня	ʃ t̪ ʃ ɔ t̪ ɪ ʒ n̪ʲ ɑ
Москви	m ɔ s̪ k v ɪ
остаточно	ɔ s̪ t̪ ɑ t̪ ɔ t̪ ʃ n̪ ɔ
обмінили	ɔ b m i n̪ ɪ l̪ ɪ
неділю	n̪ ɛ d̪ʲ i lʲ u
весілля	v ɛ s̪ i l̪ lʲ ɑ
заграли	z̪ ɑ ɦ r ɑ l̪ ɪ
півстоліття	p i v s̪ t̪ ɔ lʲ i t̪ t̪ ɑ
слів	s̪ lʲ i v
забрати	z̪ ɑ b r ɑ t̪ ɪ
гречку	ɦ r ɛ t̪ ʃ k u
елементи	ɛ l̪ ɛ m ɛ n̪ t̪ ɪ
правової	p r ɑ v ɔ v ɔ j i
низенька	n̪ ɪ z̪ ɛ n̪ʲ k ɑ
чорнява	t̪ ʃ ɔ r n̪ʲ ɑ v ɑ
заквітчана	z̪ ɑ k v i t̪ t̪ ʃ ɑ n̪ ɑ
польовими	p ɔ lʲ ɔ v ɪ m ɪ
квітками	k v i t̪ k ɑ m ɪ
УПЦ	u p t̪s̪
Московського	m ɔ s̪ k ɔ v s̪ k ɔ ɦ ɔ
патріархату	p ɑ t̪ rʲ i ɑ r x ɑ t̪ u
доступ	d̪ ɔ s̪ t̪ u p
український	u k r ɑ j i n̪ s̪ k ɪ j
капітал	k ɑ p i t̪ ɑ l̪
механізми	m ɛ x ɑ n̪ʲ i z̪ m ɪ
відбуваються	v i d̪ b u v ɑ u t̪ s̪ ɑ
реальні	r ɛ ɑ lʲ n̪ʲ i
поставити	p ɔ s̪ t̪ ɑ v ɪ t̪ ɪ
недостатньо	n̪ ɛ d̪ ɔ s̪ t̪ ɑ t̪ n̪ʲ ɔ
твої	t̪ v ɔ j i
груші	ɦ r u ʃ i
День	d̪ ɛ n̪ʲ
високим	v ɪ s̪ ɔ k ɪ m
зеленим	z̪ ɛ l̪ ɛ n̪ ɪ m
житом	ʒ ɪ t̪ ɔ m
здавалася	z̪ d̪ ɑ v ɑ l̪ ɑ s̪ ɑ
русалкою	r u s̪ ɑ l̪ k ɔ u
третє	t̪ r ɛ t̪ ɛ
культура	k u lʲ t̪ u r ɑ
перевагу	p ɛ r ɛ v ɑ ɦ u
справжня	s̪ p r ɑ v ʒ n̪ʲ ɑ
СБУ	s̪ b u
підключили	p i d̪ k lʲ u t̪ ʃ ɪ l̪ ɪ
атаки	ɑ t̪ ɑ k ɪ
Нібулон	n̪ʲ i b u l̪ ɔ n̪
татар	t̪ ɑ t̪ ɑ r
замок	z̪ ɑ m ɔ k
найбільший	n̪ ɑ j b i lʲ ʃ ɪ j
виконати	v ɪ k ɔ n̪ ɑ t̪ ɪ
обіцянки	ɔ b i t̪s̪ʲ ɑ n̪ k ɪ
ідеться	i d̪ ɛ t̪ s̪ ɑ
одну	ɔ d̪ n̪ u
попри	p ɔ p r ɪ
давав	d̪ ɑ v ɑ v
відповідні	v i d̪ p ɔ v i d̪ n̪ʲ i
Тепер	t̪ ɛ p ɛ r
головні	ɦ ɔ l̪ ɔ v n̪ʲ i
об'єкти	ɔ b j ɛ k t̪ ɪ
критики	k r ɪ t̪ ɪ k ɪ
двадцятого	d̪ v ɑ d̪ t̪s̪ʲ ɑ t̪ ɔ ɦ ɔ
акція	ɑ k t̪s̪ʲ i ɑ
робив	r ɔ b ɪ v
Шахтар	ʃ ɑ x t̪ ɑ r
затриманих	z̪ ɑ t̪ r ɪ m ɑ n̪ ɪ x
міліціонерів	m i lʲ i t̪s̪ʲ i ɔ n̪ ɛ rʲ i v
кримінальні	k r ɪ m i n̪ ɑ lʲ n̪ʲ i
президентом	p r ɛ z̪ ɪ d̪ ɛ n̪ t̪ ɔ m
євроінтеграція	j ɛ v r ɔ i n̪ t̪ ɛ ɦ r ɑ t̪s̪ʲ i ɑ
збереження	z̪ b ɛ r ɛ ʒ ɛ n̪ n̪ʲ ɑ
здорового	z̪ d̪ ɔ r ɔ v ɔ ɦ ɔ
природного	p r ɪ r ɔ d̪ n̪ ɔ ɦ ɔ
середовища	s̪ ɛ r ɛ d̪ ɔ v ɪ ʃ t̪ ʃ ɑ
очах	ɔ t̪ ʃ ɑ x
Лукашенка	l̪ u k ɑ ʃ ɛ n̪ k ɑ
страх	s̪ t̪ r ɑ x
радянських	r ɑ d̪ʲ ɑ n̪ s̪ k ɪ x
часів	t̪ ʃ ɑ s̪ i v
отримала	ɔ t̪ r ɪ m ɑ l̪ ɑ
владу	v l̪ ɑ d̪ u
бою	b ɔ u
насамперед	n̪ ɑ s̪ ɑ m p ɛ r ɛ d̪
неминуче	n̪ ɛ m ɪ n̪ u t̪ ʃ ɛ
починати	p ɔ t̪ ʃ ɪ n̪ ɑ t̪ ɪ
марафон	m ɑ r ɑ f ɔ n̪
році	r ɔ t̪s̪ʲ i
завод	z̪ ɑ v ɔ d̪
склад	s̪ k l̪ ɑ d̪
місцевих	m i s̪ t̪s̪ ɛ v ɪ x
органів	ɔ r ɦ ɑ n̪ʲ i v
ювілею	j u v i l̪ ɛ u
перемогу	p ɛ r ɛ m ɔ ɦ u
розмову	r ɔ z̪ m ɔ v u
біржі	b i r ʒ i
навпаки	n̪ ɑ v p ɑ k ɪ
прибули	p r ɪ b u l̪ ɪ
керівництво	k ɛ rʲ i v n̪ ɪ t̪s̪ t̪ v ɔ
діло	d̪ʲ i l̪ ɔ
Одещині	ɔ d̪ ɛ ʃ t̪ ʃ ɪ n̪ʲ i
прийти	p r ɪ j t̪ ɪ
сесію	s̪ ɛ s̪ i u
початком	p ɔ t̪ ʃ ɑ t̪ k ɔ m
призвести	p r ɪ z̪ v ɛ s̪ t̪ ɪ
наслідків	n̪ ɑ s̪ lʲ i d̪ k i v
продовжують	p r ɔ d̪ ɔ v ʒ u u t̪
купувати	k u p u v ɑ t̪ ɪ
путівки	p u t̪ i v k ɪ
якихось	j ɑ k ɪ x ɔ s̪
півтора	p i v t̪ ɔ r ɑ
відсотка	v i d̪ s̪ ɔ t̪ k ɑ
голосів	ɦ ɔ l̪ ɔ s̪ i v
зустрінуться	z̪ u s̪ t̪ rʲ i n̪ u t̪ s̪ ɑ
вид	v ɪ d̪
тихий	t̪ ɪ x ɪ j
смутний	s̪ m u t̪ n̪ ɪ j
опонентів	ɔ p ɔ n̪ ɛ n̪ t̪ i v
конкретні	k ɔ n̪ k r ɛ t̪ n̪ʲ i
цікавить	t̪s̪ʲ i k ɑ v ɪ t̪
цьогоріч	t̪s̪ʲ ɔ ɦ ɔ rʲ i t̪ ʃ
прийшлося	p r ɪ j ʃ l̪ ɔ s̪ ɑ
своїми	s̪ v ɔ j i m ɪ
пропозиція	p r ɔ p ɔ z̪ ɪ t̪s̪ʲ i ɑ
послав	p ɔ s̪ l̪ ɑ v
випадку	v ɪ p ɑ d̪ k u
вхід	v x i d̪
вільний	v i lʲ n̪ ɪ j
країною	k r ɑ j i n̪ ɔ u
Британії	b r ɪ t̪ ɑ n̪ʲ i j i
Америка	ɑ m ɛ r ɪ k ɑ
історичні	i s̪ t̪ ɔ r ɪ t̪ ʃ n̪ʲ i
посадили	p ɔ s̪ ɑ d̪ ɪ l̪ ɪ
герой	ɦ ɛ r ɔ j
рідній	rʲ i d̪ n̪ʲ i j
світла	s̪ v i t̪ l̪ ɑ
Апеляційний	ɑ p ɛ lʲ ɑ t̪s̪ʲ i j n̪ ɪ j
Чернігівської	t̪ ʃ ɛ r n̪ʲ i ɦ i v s̪ k ɔ j i
залишив	z̪ ɑ l̪ ɪ ʃ ɪ v
котрі	k ɔ t̪ rʲ i
участь	u t̪ ʃ ɑ s̪ t̪
повністю	p ɔ v n̪ʲ i s̪ t̪ u
провину	p r ɔ v ɪ n̪ u
Василя	v ɑ s̪ ɪ lʲ ɑ
Шкляра	ʃ k lʲ ɑ r ɑ
Чорний	t̪ ʃ ɔ r n̪ ɪ j
Ворон	v ɔ r ɔ n̪
потрібне	p ɔ t̪ rʲ i b n̪ ɛ
втручання	v t̪ r u t̪ ʃ ɑ n̪ n̪ʲ ɑ
музика	m u z̪ ɪ k ɑ
врятувати	v rʲ ɑ t̪ u v ɑ t̪ ɪ
дівчину	d̪ʲ i v t̪ ʃ ɪ n̪ u
корупції	k ɔ r u p t̪s̪ʲ i j i
статті	s̪ t̪ ɑ t̪ t̪ i
закриття	z̪ ɑ k r ɪ t̪ t̪ ɑ
шляхів	ʃ lʲ ɑ x i v
скорочення	s̪ k ɔ r ɔ t̪ ʃ ɛ n̪ n̪ʲ ɑ
черги	t̪ ʃ ɛ r ɦ ɪ
соціальне	s̪ ɔ t̪s̪ʲ i ɑ lʲ n̪ ɛ
справжній	s̪ p r ɑ v ʒ n̪ʲ i j
літературних	lʲ i t̪ ɛ r ɑ t̪ u r n̪ ɪ x
творів	t̪ v ɔ rʲ i v
перебувають	p ɛ r ɛ b u v ɑ u t̪
національна	n̪ ɑ t̪s̪ʲ i ɔ n̪ ɑ lʲ n̪ ɑ
міркували	m i r k u v ɑ l̪ ɪ
страшенно	s̪ t̪ r ɑ ʃ ɛ n̪ n̪ ɔ
важкою	v ɑ ʒ k ɔ u
проблемою	p r ɔ b l̪ ɛ m ɔ u
провести	p r ɔ v ɛ s̪ t̪ ɪ
модернізацію	m ɔ d̪ ɛ r n̪ʲ i z̪ ɑ t̪s̪ʲ i u
суспільну	s̪ u s̪ p i lʲ n̪ u
модернізації	m ɔ d̪ ɛ r n̪ʲ i z̪ ɑ t̪s̪ʲ i j i
опитування	ɔ p ɪ t̪ u v ɑ n̪ n̪ʲ ɑ
передають	p ɛ r ɛ d̪ ɑ u t̪
молода	m ɔ l̪ ɔ d̪ ɑ
кінець	k i n̪ ɛ t̪s̪ʲ
Мотрю	m ɔ t̪ rʲ u
жалує	ʒ ɑ l̪ u ɛ
тещі	t̪ ɛ ʃ t̪ ʃ i
ласкавий	l̪ ɑ s̪ k ɑ v ɪ j
чутка	t̪ ʃ u t̪ k ɑ
Великдень	v ɛ l̪ ɪ k d̪ ɛ n̪ʲ
прийняти	p r ɪ j n̪ʲ ɑ t̪ ɪ
театру	t̪ ɛ ɑ t̪ r u
прем'єра	p r ɛ m j ɛ r ɑ
пропонується	p r ɔ p ɔ n̪ u ɛ t̪ s̪ ɑ
Азарова	ɑ z̪ ɑ r ɔ v ɑ
скасувати	s̪ k ɑ s̪ u v ɑ t̪ ɪ
податки	p ɔ d̪ ɑ t̪ k ɪ
мільйони	m i lʲ j ɔ n̪ ɪ
половину	p ɔ l̪ ɔ v ɪ n̪ u
виступав	v ɪ s̪ t̪ u p ɑ v
мета	m ɛ t̪ ɑ
промовить	p r ɔ m ɔ v ɪ t̪
допомога	d̪ ɔ p ɔ m ɔ ɦ ɑ
загинув	z̪ ɑ ɦ ɪ n̪ u v
райвідділу	r ɑ j v i d̪ d̪ʲ i l̪ u
знаходяться	z̪ n̪ ɑ x ɔ d̪ʲ ɑ t̪ s̪ ɑ
залі	z̪ ɑ lʲ i
враховуючи	v r ɑ x ɔ v u u t̪ ʃ ɪ
динаміку	d̪ ɪ n̪ ɑ m i k u
потреб	p ɔ t̪ r ɛ b
вважаю	v v ɑ ʒ ɑ u
список	s̪ p ɪ s̪ ɔ k
продовжувати	p r ɔ d̪ ɔ v ʒ u v ɑ t̪ ɪ
підозрюваних	p i d̪ ɔ z̪ rʲ u v ɑ n̪ ɪ x
прізвища	p rʲ i z̪ v ɪ ʃ t̪ ʃ ɑ
спустилася	s̪ p u s̪ t̪ ɪ l̪ ɑ s̪ ɑ
єдиним	j ɛ d̪ ɪ n̪ ɪ m
Надаль	n̪ ɑ d̪ ɑ lʲ
повечеряв	p ɔ v ɛ t̪ ʃ ɛ rʲ ɑ v
пишу	p ɪ ʃ u
сумних	s̪ u m n̪ ɪ x
пісень	p i s̪ ɛ n̪ʲ
бібліотеки	b i b lʲ i ɔ t̪ ɛ k ɪ
поїхав	p ɔ j i x ɑ v
залишився	z̪ ɑ l̪ ɪ ʃ ɪ v s̪ ɑ
взяла	v z̪ʲ ɑ l̪ ɑ
ініціативу	i n̪ʲ i t̪s̪ʲ i ɑ t̪ ɪ v u
руки	r u k ɪ
голосували	ɦ ɔ l̪ ɔ s̪ u v ɑ l̪ ɪ
бува	b u v ɑ
холод	x ɔ l̪ ɔ d̪
буйний	b u j n̪ ɪ j
вітер	v i t̪ ɛ r
крутив	k r u t̪ ɪ v
заметами	z̪ ɑ m ɛ t̪ ɑ m ɪ
вив	v ɪ v
звір	z̪ v i r
університетів	u n̪ʲ i v ɛ r s̪ ɪ t̪ ɛ t̪ i v
небі	n̪ ɛ b i
сонця	s̪ ɔ n̪ t̪s̪ʲ ɑ
погода	p ɔ ɦ ɔ d̪ ɑ
розпочав	r ɔ z̪ p ɔ t̪ ʃ ɑ v
порожні	p ɔ r ɔ ʒ n̪ʲ i
половини	p ɔ l̪ ɔ v ɪ n̪ ɪ
кількості	k i lʲ k ɔ s̪ t̪ i
задля	z̪ ɑ d̪ lʲ ɑ
фігурному	f i ɦ u r n̪ ɔ m u
катанні	k ɑ t̪ ɑ n̪ n̪ʲ i
працівників	p r ɑ t̪s̪ʲ i v n̪ ɪ k i v
галузі	ɦ ɑ l̪ u z̪ʲ i
протягом	p r ɔ t̪ ɑ ɦ ɔ m
останнього	ɔ s̪ t̪ ɑ n̪ n̪ʲ ɔ ɦ ɔ
опустить	ɔ p u s̪ t̪ ɪ t̪
груди	ɦ r u d̪ ɪ
голову	ɦ ɔ l̪ ɔ v u
квітня	k v i t̪ n̪ʲ ɑ
скасував	s̪ k ɑ s̪ u v ɑ v
квоти	k v ɔ t̪ ɪ
кукурудзи	k u k u r u d̪ z̪ ɪ
тепереньки	t̪ ɛ p ɛ r ɛ n̪ʲ k ɪ
творчий	t̪ v ɔ r t̪ ʃ ɪ j
акцій	ɑ k t̪s̪ʲ i j
владою	v l̪ ɑ d̪ ɔ u
досвід	d̪ ɔ s̪ v i d̪
четвертої	t̪ ʃ ɛ t̪ v ɛ r t̪ ɔ j i
дівчата	d̪ʲ i v t̪ ʃ ɑ t̪ ɑ
залишили	z̪ ɑ l̪ ɪ ʃ ɪ l̪ ɪ
надання	n̪ ɑ d̪ ɑ n̪ n̪ʲ ɑ
надзвичайних	n̪ ɑ d̪ z̪ v ɪ t̪ ʃ ɑ j n̪ ɪ x
вспіло	v s̪ p i l̪ ɔ
наложити	n̪ ɑ l̪ ɔ ʒ ɪ t̪ ɪ
палючих	p ɑ lʲ u t̪ ʃ ɪ x
слідів	s̪ lʲ i d̪ʲ i v
запитала	z̪ ɑ p ɪ t̪ ɑ l̪ ɑ
зляканим	z̪ lʲ ɑ k ɑ n̪ ɪ m
балакучий	b ɑ l̪ ɑ k u t̪ ʃ ɪ j
щирий	ʃ t̪ ʃ ɪ r ɪ j
економіку	ɛ k ɔ n̪ ɔ m i k u
Білорусі	b i l̪ ɔ r u s̪ i
валютних	v ɑ lʲ u t̪ n̪ ɪ x
карті	k ɑ r t̪ i
різниця	rʲ i z̪ n̪ ɪ t̪s̪ʲ ɑ
відомий	v i d̪ ɔ m ɪ j
Черкащині	t̪ ʃ ɛ r k ɑ ʃ t̪ ʃ ɪ n̪ʲ i
кризи	k r ɪ z̪ ɪ
Луганську	l̪ u ɦ ɑ n̪ s̪ k u
чесно	t̪ ʃ ɛ s̪ n̪ ɔ
вулиця	v u l̪ ɪ t̪s̪ʲ ɑ
голосування	ɦ ɔ l̪ ɔ s̪ u v ɑ n̪ n̪ʲ ɑ
зате	z̪ ɑ t̪ ɛ
посеред	p ɔ s̪ ɛ r ɛ d̪
залу	z̪ ɑ l̪ u
Ліни	lʲ i n̪ ɪ
Костенко	k ɔ s̪ t̪ ɛ n̪ k ɔ
чекали	t̪ ʃ ɛ k ɑ l̪ ɪ
гості	ɦ ɔ s̪ t̪ i
родичів	r ɔ d̪ ɪ t̪ ʃ i v
жоден	ʒ ɔ d̪ ɛ n̪
трагедії	t̪ r ɑ ɦ ɛ d̪ʲ i j i
оперативники	ɔ p ɛ r ɑ t̪ ɪ v n̪ ɪ k ɪ
діяли	d̪ʲ i ɑ l̪ ɪ
звернути	z̪ v ɛ r n̪ u t̪ ɪ
увагу	u v ɑ ɦ u
двічі	d̪ v i t̪ ʃ i
Андрія	ɑ n̪ d̪ rʲ i ɑ
пройти	p r ɔ j t̪ ɪ
парламент	p ɑ r l̪ ɑ m ɛ n̪ t̪
хаті	x ɑ t̪ i
навести	n̪ ɑ v ɛ s̪ t̪ ɪ
театрі	t̪ ɛ ɑ t̪ rʲ i
дивідендів	d̪ ɪ v i d̪ ɛ n̪ d̪ʲ i v
подати	p ɔ d̪ ɑ t̪ ɪ
чув	t̪ ʃ u v
попереднього	p ɔ p ɛ r ɛ d̪ n̪ʲ ɔ ɦ ɔ
прагнуть	p r ɑ ɦ n̪ u t̪
обов'язок	ɔ b ɔ v j ɑ z̪ ɔ k
недавно	n̪ ɛ d̪ ɑ v n̪ ɔ
НАТО	n̪ ɑ t̪ ɔ
збірна	z̪ b i r n̪ ɑ
однією	ɔ d̪ n̪ʲ i ɛ u
найсильніших	n̪ ɑ j s̪ ɪ lʲ n̪ʲ i ʃ ɪ x
Марічка	m ɑ rʲ i t̪ ʃ k ɑ
ввійшла	v v i j ʃ l̪ ɑ
убогу	u b ɔ ɦ u
хатину	x ɑ t̪ ɪ n̪ u
стовпом	s̪ t̪ ɔ v p ɔ m
батьками	b ɑ t̪ k ɑ m ɪ
пісні	p i s̪ n̪ʲ i
Сполучені	s̪ p ɔ l̪ u t̪ ʃ ɛ n̪ʲ i
Штати	ʃ t̪ ɑ t̪ ɪ
займається	z̪ ɑ j m ɑ ɛ t̪ s̪ ɑ
відділення	v i d̪ d̪ʲ i l̪ ɛ n̪ n̪ʲ ɑ
сільських	s̪ i lʲ s̪ k ɪ x
шкіл	ʃ k i l̪
господаря	ɦ ɔ s̪ p ɔ d̪ ɑ rʲ ɑ
присутні	p r ɪ s̪ u t̪ n̪ʲ i
повідомив	p ɔ v i d̪ ɔ m ɪ v
зими	z̪ ɪ m ɪ
ремонту	r ɛ m ɔ n̪ t̪ u
зарізав	z̪ ɑ rʲ i z̪ ɑ v
осені	ɔ s̪ ɛ n̪ʲ i
уряді	u rʲ ɑ d̪ʲ i
нібито	n̪ʲ i b ɪ t̪ ɔ
повертається	p ɔ v ɛ r t̪ ɑ ɛ t̪ s̪ ɑ
свобода	s̪ v ɔ b ɔ d̪ ɑ
автор	ɑ v t̪ ɔ r
першого	p ɛ r ʃ ɔ ɦ ɔ
поляки	p ɔ lʲ ɑ k ɪ
українське	u k r ɑ j i n̪ s̪ k ɛ
кіно	k i n̪ ɔ
підтримку	p i d̪ t̪ r ɪ m k u
дитина	d̪ ɪ t̪ ɪ n̪ ɑ
подякувати	p ɔ d̪ʲ ɑ k u v ɑ t̪ ɪ
випадків	v ɪ p ɑ d̪ k i v
демократичний	d̪ ɛ m ɔ k r ɑ t̪ ɪ t̪ ʃ n̪ ɪ j
нинішня	n̪ ɪ n̪ʲ i ʃ n̪ʲ ɑ
партії	p ɑ r t̪ i j i
їхню	j i x n̪ʲ u
могла	m ɔ ɦ l̪ ɑ
шукали	ʃ u k ɑ l̪ ɪ
рідні	rʲ i d̪ n̪ʲ i
пишуть	p ɪ ʃ u t̪
Чорне	t̪ ʃ ɔ r n̪ ɛ
море	m ɔ r ɛ
напередодні	n̪ ɑ p ɛ r ɛ d̪ ɔ d̪ n̪ʲ i
екологічної	ɛ k ɔ l̪ ɔ ɦ i t̪ ʃ n̪ ɔ j i
катастрофи	k ɑ t̪ ɑ s̪ t̪ r ɔ f ɪ
національний	n̪ ɑ t̪s̪ʲ i ɔ n̪ ɑ lʲ n̪ ɪ j
зустрічі	z̪ u s̪ t̪ rʲ i t̪ ʃ i
деякими	d̪ ɛ ɑ k ɪ m ɪ
працівниками	p r ɑ t̪s̪ʲ i v n̪ ɪ k ɑ m ɪ
інституту	i n̪ s̪ t̪ ɪ t̪ u t̪ u
Комітету	k ɔ m i t̪ ɛ t̪ u
злочину	z̪ l̪ ɔ t̪ ʃ ɪ n̪ u
провели	p r ɔ v ɛ l̪ ɪ
ходиш	x ɔ d̪ ɪ ʃ
цілу	t̪s̪ʲ i l̪ u
низку	n̪ ɪ z̪ k u
черга	t̪ ʃ ɛ r ɦ ɑ
нерухомість	n̪ ɛ r u x ɔ m i s̪ t̪
членів	t̪ ʃ l̪ ɛ n̪ʲ i v
паршивого	p ɑ r ʃ ɪ v ɔ ɦ ɔ
кабана	k ɑ b ɑ n̪ ɑ
сміли	s̪ m i l̪ ɪ
коня	k ɔ n̪ʲ ɑ
поступки	p ɔ s̪ t̪ u p k ɪ
глави	ɦ l̪ ɑ v ɪ
варто	v ɑ r t̪ ɔ
Юлії	j u lʲ i j i
сенсі	s̪ ɛ n̪ s̪ i
сьоме	s̪ ɔ m ɛ
чиї	t̪ ʃ ɪ j i
товариство	t̪ ɔ v ɑ r ɪ s̪ t̪ v ɔ
вихід	v ɪ x i d̪
власників	v l̪ ɑ s̪ n̪ ɪ k i v
службових	s̪ l̪ u ʒ b ɔ v ɪ x
завданням	z̪ ɑ v d̪ ɑ n̪ n̪ʲ ɑ m
працю	p r ɑ t̪s̪ʲ u
схожа	s̪ x ɔ ʒ ɑ
селянок	s̪ ɛ lʲ ɑ n̪ ɔ k
встала	v s̪ t̪ ɑ l̪ ɑ
генеральша	ɦ ɛ n̪ ɛ r ɑ lʲ ʃ ɑ
винні	v ɪ n̪ n̪ʲ i
самостійно	s̪ ɑ m ɔ s̪ t̪ i j n̪ ɔ
робочої	r ɔ b ɔ t̪ ʃ ɔ j i
увійшли	u v i j ʃ l̪ ɪ
вважати	v v ɑ ʒ ɑ t̪ ɪ
підтримка	p i d̪ t̪ r ɪ m k ɑ
українських	u k r ɑ j i n̪ s̪ k ɪ x
Різдва	rʲ i z̪ d̪ v ɑ
красувалася	k r ɑ s̪ u v ɑ l̪ ɑ s̪ ɑ
їхніх	j i x n̪ʲ i x
даному	d̪ ɑ n̪ ɔ m u
мовби	m ɔ v b ɪ
народжується	n̪ ɑ r ɔ d̪ ʒ u ɛ t̪ s̪ ɑ
вірш	v i r ʃ
Михайлини	m ɪ x ɑ j l̪ ɪ n̪ ɪ
Хомівни	x ɔ m i v n̪ ɪ
річниці	rʲ i t̪ ʃ n̪ ɪ t̪s̪ʲ i
міський	m i s̪ k ɪ j
зелена	z̪ ɛ l̪ ɛ n̪ ɑ
керсетка	k ɛ r s̪ ɛ t̪ k ɑ
червона	t̪ ʃ ɛ r v ɔ n̪ ɑ
спідниця	s̪ p i d̪ n̪ ɪ t̪s̪ʲ ɑ
минулих	m ɪ n̪ u l̪ ɪ x
Його	j ɔ ɦ ɔ
кожному	k ɔ ʒ n̪ ɔ m u
бувають	b u v ɑ u t̪
називати	n̪ ɑ z̪ ɪ v ɑ t̪ ɪ
мамою	m ɑ m ɔ u
мов	m ɔ v
легко	l̪ ɛ ɦ k ɔ
сумно	s̪ u m n̪ ɔ
весело	v ɛ s̪ ɛ l̪ ɔ
свідків	s̪ v i d̪ k i v
Одесі	ɔ d̪ ɛ s̪ i
Генпрокуратури	ɦ ɛ n̪ p r ɔ k u r ɑ t̪ u r ɪ
горою	ɦ ɔ r ɔ u
зеленої	z̪ ɛ l̪ ɛ n̪ ɔ j i
левади	l̪ ɛ v ɑ d̪ ɪ
притаманна	p r ɪ t̪ ɑ m ɑ n̪ n̪ ɑ
історикові	i s̪ t̪ ɔ r ɪ k ɔ v i
звичка	z̪ v ɪ t̪ ʃ k ɑ
оперувати	ɔ p ɛ r u v ɑ t̪ ɪ
десятиліттями	d̪ ɛ s̪ ɑ t̪ ɪ lʲ i t̪ t̪ ɑ m ɪ
змінювалися	z̪ m i n̪ʲ u v ɑ l̪ ɪ s̪ ɑ
втратив	v t̪ r ɑ t̪ ɪ v
довіру	d̪ ɔ v i r u
третьої	t̪ r ɛ t̪ ɔ j i
якось	j ɑ k ɔ s̪
давали	d̪ ɑ v ɑ l̪ ɪ
залишилося	z̪ ɑ l̪ ɪ ʃ ɪ l̪ ɔ s̪ ɑ
російські	r ɔ s̪ i j s̪ k i
дитинства	d̪ ɪ t̪ ɪ n̪ s̪ t̪ v ɑ
вірити	v i r ɪ t̪ ɪ
кинув	k ɪ n̪ u v
троє	t̪ r ɔ ɛ
вихованців	v ɪ x ɔ v ɑ n̪ t̪s̪ʲ i v
дочки	d̪ ɔ t̪ ʃ k ɪ
дочок	d̪ ɔ t̪ ʃ ɔ k
розглядати	r ɔ z̪ ɦ lʲ ɑ d̪ ɑ t̪ ɪ
оновлення	ɔ n̪ ɔ v l̪ ɛ n̪ n̪ʲ ɑ
середня	s̪ ɛ r ɛ d̪ n̪ʲ ɑ
заробітна	z̪ ɑ r ɔ b i t̪ n̪ ɑ
плата	p l̪ ɑ t̪ ɑ
Ви	v ɪ
далекої	d̪ ɑ l̪ ɛ k ɔ j i
відкрив	v i d̪ k r ɪ v
нову	n̪ ɔ v u
реальність	r ɛ ɑ lʲ n̪ʲ i s̪ t̪
сподівалися	s̪ p ɔ d̪ʲ i v ɑ l̪ ɪ s̪ ɑ
шостого	ʃ ɔ s̪ t̪ ɔ ɦ ɔ
прийнято	p r ɪ j n̪ʲ ɑ t̪ ɔ
потерпілих	p ɔ t̪ ɛ r p i l̪ ɪ x
суботу	s̪ u b ɔ t̪ u
загиблих	z̪ ɑ ɦ ɪ b l̪ ɪ x
поховали	p ɔ x ɔ v ɑ l̪ ɪ
кількість	k i lʲ k i s̪ t̪
зменшилася	z̪ m ɛ n̪ ʃ ɪ l̪ ɑ s̪ ɑ
втричі	v t̪ r ɪ t̪ ʃ i
відкрито	v i d̪ k r ɪ t̪ ɔ
межі	m ɛ ʒ i
смерті	s̪ m ɛ r t̪ i
стадіону	s̪ t̪ ɑ d̪ʲ i ɔ n̪ u
немов	n̪ ɛ m ɔ v
понеділок	p ɔ n̪ ɛ d̪ʲ i l̪ ɔ k
спікер	s̪ p i k ɛ r
пускають	p u s̪ k ɑ u t̪
назвав	n̪ ɑ z̪ v ɑ v
певну	p ɛ v n̪ u
квартир	k v ɑ r t̪ ɪ r
машин	m ɑ ʃ ɪ n̪
тощо	t̪ ɔ ʃ t̪ ʃ ɔ
кубометрів	k u b ɔ m ɛ t̪ rʲ i v
прийшло	p r ɪ j ʃ l̪ ɔ
західного	z̪ ɑ x i d̪ n̪ ɔ ɦ ɔ
комуністів	k ɔ m u n̪ʲ i s̪ t̪ i v
прості	p r ɔ s̪ t̪ i
москалі	m ɔ s̪ k ɑ lʲ i
Сидір	s̪ ɪ d̪ʲ i r
Анжи	ɑ n̪ ʒ ɪ
досягти	d̪ ɔ s̪ ɑ ɦ t̪ ɪ
Шахтаря	ʃ ɑ x t̪ ɑ rʲ ɑ
команди	k ɔ m ɑ n̪ d̪ ɪ
пенсійне	p ɛ n̪ s̪ i j n̪ ɛ
працівника	p r ɑ t̪s̪ʲ i v n̪ ɪ k ɑ
кохання	k ɔ x ɑ n̪ n̪ʲ ɑ
їхній	j i x n̪ʲ i j
заходу	z̪ ɑ x ɔ d̪ u
збирати	z̪ b ɪ r ɑ t̪ ɪ
групу	ɦ r u p u
родина	r ɔ d̪ ɪ n̪ ɑ
голосував	ɦ ɔ l̪ ɔ s̪ u v ɑ v
серйозні	s̪ ɛ r j ɔ z̪ n̪ʲ i
сенс	s̪ ɛ n̪ s̪
виставки	v ɪ s̪ t̪ ɑ v k ɪ
виконує	v ɪ k ɔ n̪ u ɛ
прес–служба	p r ɛ s̪ s̪ l̪ u ʒ b ɑ
Міністерства	m i n̪ʲ i s̪ t̪ ɛ r s̪ t̪ v ɑ
салоні	s̪ ɑ l̪ ɔ n̪ʲ i
бізнесу	b i z̪ n̪ ɛ s̪ u
варіант	v ɑ rʲ i ɑ n̪ t̪
російської	r ɔ s̪ i j s̪ k ɔ j i
моделі	m ɔ d̪ ɛ lʲ i
система	s̪ ɪ s̪ t̪ ɛ m ɑ
пожежа	p ɔ ʒ ɛ ʒ ɑ
складають	s̪ k l̪ ɑ d̪ ɑ u t̪
відповідають	v i d̪ p ɔ v i d̪ ɑ u t̪
Конституції	k ɔ n̪ s̪ t̪ ɪ t̪ u t̪s̪ʲ i j i
нікуди	n̪ʲ i k u d̪ ɪ
зникла	z̪ n̪ ɪ k l̪ ɑ
вчені	v t̪ ʃ ɛ n̪ʲ i
читайте	t̪ ʃ ɪ t̪ ɑ j t̪ ɛ
чорного	t̪ ʃ ɔ r n̪ ɔ ɦ ɔ
етапі	ɛ t̪ ɑ p i
видатного	v ɪ d̪ ɑ t̪ n̪ ɔ ɦ ɔ
зброї	z̪ b r ɔ j i
проведення	p r ɔ v ɛ d̪ ɛ n̪ n̪ʲ ɑ
операції	ɔ p ɛ r ɑ t̪s̪ʲ i j i
кандидат	k ɑ n̪ d̪ ɪ d̪ ɑ t̪
юридичних	j u r ɪ d̪ ɪ t̪ ʃ n̪ ɪ x
ПР	p r
створено	s̪ t̪ v ɔ r ɛ n̪ ɔ
спеціальну	s̪ p ɛ t̪s̪ʲ i ɑ lʲ n̪ u
комісію	k ɔ m i s̪ i u
власної	v l̪ ɑ s̪ n̪ ɔ j i
агентства	ɑ ɦ ɛ n̪ t̪ s̪ t̪ v ɑ
тієї	t̪ i ɛ j i
поїздки	p ɔ j i z̪ d̪ k ɪ
Андрій	ɑ n̪ d̪ rʲ i j
готують	ɦ ɔ t̪ u u t̪
спеціально	s̪ p ɛ t̪s̪ʲ i ɑ lʲ n̪ ɔ
офіційний	ɔ f i t̪s̪ʲ i j n̪ ɪ j
збірної	z̪ b i r n̪ ɔ j i
купівлі	k u p i v lʲ i
їде	j i d̪ ɛ
молоко	m ɔ l̪ ɔ k ɔ
ближче	b l̪ ɪ ʒ t̪ ʃ ɛ
лідера	lʲ i d̪ ɛ r ɑ
ніде	n̪ʲ i d̪ ɛ
газета	ɦ ɑ z̪ ɛ t̪ ɑ
Дело	d̪ ɛ l̪ ɔ
різними	rʲ i z̪ n̪ ɪ m ɪ
гречки	ɦ r ɛ t̪ ʃ k ɪ
відбувалися	v i d̪ b u v ɑ l̪ ɪ s̪ ɑ
головним	ɦ ɔ l̪ ɔ v n̪ ɪ m
Дніпро	d̪ n̪ʲ i p r ɔ
розпочинає	r ɔ z̪ p ɔ t̪ ʃ ɪ n̪ ɑ ɛ
підготовку	p i d̪ ɦ ɔ t̪ ɔ v k u
Шахтарем	ʃ ɑ x t̪ ɑ r ɛ m
прекрасно	p r ɛ k r ɑ s̪ n̪ ɔ
фінансову	f i n̪ ɑ n̪ s̪ ɔ v u
розібратися	r ɔ z̪ʲ i b r ɑ t̪ ɪ s̪ ɑ
прочитати	p r ɔ t̪ ʃ ɪ t̪ ɑ t̪ ɪ
обласний	ɔ b l̪ ɑ s̪ n̪ ɪ j
замість	z̪ ɑ m i s̪ t̪
мами	m ɑ m ɪ
глуха	ɦ l̪ u x ɑ
стіна	s̪ t̪ i n̪ ɑ
малим	m ɑ l̪ ɪ m
паровиць	p ɑ r ɔ v ɪ t̪s̪ʲ
везли	v ɛ z̪ l̪ ɪ
посаг	p ɔ s̪ ɑ ɦ
Піски	p i s̪ k ɪ
хвороба	x v ɔ r ɔ b ɑ
забрала	z̪ ɑ b r ɑ l̪ ɑ
чоловіка	t̪ ʃ ɔ l̪ ɔ v i k ɑ
десь	d̪ ɛ s̪
друг	d̪ r u ɦ
Віктора	v i k t̪ ɔ r ɑ
столом	s̪ t̪ ɔ l̪ ɔ m
сиділо	s̪ ɪ d̪ʲ i l̪ ɔ
душ	d̪ u ʃ
чужих	t̪ ʃ u ʒ ɪ x
листа	l̪ ɪ s̪ t̪ ɑ
обійтися	ɔ b i j t̪ ɪ s̪ ɑ
вища	v ɪ ʃ t̪ ʃ ɑ
областях	ɔ b l̪ ɑ s̪ t̪ ɑ x
прагне	p r ɑ ɦ n̪ ɛ
розповісти	r ɔ z̪ p ɔ v i s̪ t̪ ɪ
Металіст	m ɛ t̪ ɑ lʲ i s̪ t̪
розтрощив	r ɔ z̪ t̪ r ɔ ʃ t̪ ʃ ɪ v
Зальцбург	z̪ ɑ lʲ t̪s̪ b u r ɦ
Українського	u k r ɑ j i n̪ s̪ k ɔ ɦ ɔ
аграрного	ɑ ɦ r ɑ r n̪ ɔ ɦ ɔ
Земля	z̪ ɛ m lʲ ɑ
жертвою	ʒ ɛ r t̪ v ɔ u
встигла	v s̪ t̪ ɪ ɦ l̪ ɑ
пройшли	p r ɔ j ʃ l̪ ɪ
верстов	v ɛ r s̪ t̪ ɔ v
почув	p ɔ t̪ ʃ u v
відчув	v i d̪ t̪ ʃ u v
штани	ʃ t̪ ɑ n̪ ɪ
вибійчані	v ɪ b i j t̪ ʃ ɑ n̪ʲ i
підсукані	p i d̪ s̪ u k ɑ n̪ʲ i
колін	k ɔ lʲ i n̪
минулому	m ɪ n̪ u l̪ ɔ m u
лікар	lʲ i k ɑ r
підтримати	p i d̪ t̪ r ɪ m ɑ t̪ ɪ
термін	t̪ ɛ r m i n̪
спосіб	s̪ p ɔ s̪ i b
спрямована	s̪ p rʲ ɑ m ɔ v ɑ n̪ ɑ
пенсійна	p ɛ n̪ s̪ i j n̪ ɑ
реформа	r ɛ f ɔ r m ɑ
істориків	i s̪ t̪ ɔ r ɪ k i v
Миколу	m ɪ k ɔ l̪ u
підприємці	p i d̪ p r ɪ ɛ m t̪s̪ʲ i
непопулярний	n̪ ɛ p ɔ p u lʲ ɑ r n̪ ɪ j
мітингу	m i t̪ ɪ n̪ ɦ u
сміття	s̪ m i t̪ t̪ ɑ
реакція	r ɛ ɑ k t̪s̪ʲ i ɑ
дівчинки	d̪ʲ i v t̪ ʃ ɪ n̪ k ɪ
гонить	ɦ ɔ n̪ ɪ t̪
оплату	ɔ p l̪ ɑ t̪ u
забезпечити	z̪ ɑ b ɛ z̪ p ɛ t̪ ʃ ɪ t̪ ɪ
роботою	r ɔ b ɔ t̪ ɔ u
Богом	b ɔ ɦ ɔ m
закладено	z̪ ɑ k l̪ ɑ d̪ ɛ n̪ ɔ
віддати	v i d̪ d̪ ɑ t̪ ɪ
добрим	d̪ ɔ b r ɪ m
Коць	k ɔ t̪s̪ʲ
прибув	p r ɪ b u v
слідчий	s̪ lʲ i d̪ t̪ ʃ ɪ j
лірика	lʲ i r ɪ k ɑ
дитячого	d̪ ɪ t̪ ɑ t̪ ʃ ɔ ɦ ɔ
парку	p ɑ r k u
шостому	ʃ ɔ s̪ t̪ ɔ m u
Чемпіонату	t̪ ʃ ɛ m p i ɔ n̪ ɑ t̪ u
Світу	s̪ v i t̪ u
футболу	f u t̪ b ɔ l̪ u
підтримують	p i d̪ t̪ r ɪ m u u t̪
пита	p ɪ t̪ ɑ
письменник	p ɪ s̪ m ɛ n̪ n̪ ɪ k
кредит	k r ɛ d̪ ɪ t̪
російська	r ɔ s̪ i j s̪ k ɑ
сторона	s̪ t̪ ɔ r ɔ n̪ ɑ
поставив	p ɔ s̪ t̪ ɑ v ɪ v
хата	x ɑ t̪ ɑ
відкрився	v i d̪ k r ɪ v s̪ ɑ
подолання	p ɔ d̪ ɔ l̪ ɑ n̪ n̪ʲ ɑ
сил	s̪ ɪ l̪
важке	v ɑ ʒ k ɛ
революція	r ɛ v ɔ lʲ u t̪s̪ʲ i ɑ
зацікавлена	z̪ ɑ t̪s̪ʲ i k ɑ v l̪ ɛ n̪ ɑ
співпраці	s̪ p i v p r ɑ t̪s̪ʲ i
домовлятися	d̪ ɔ m ɔ v lʲ ɑ t̪ ɪ s̪ ɑ
п'яте	p j ɑ t̪ ɛ
тринадцята	t̪ r ɪ n̪ ɑ d̪ t̪s̪ʲ ɑ t̪ ɑ
свідомо	s̪ v i d̪ ɔ m ɔ
першій	p ɛ r ʃ i j
системі	s̪ ɪ s̪ t̪ ɛ m i
городі	ɦ ɔ r ɔ d̪ʲ i
виросла	v ɪ r ɔ s̪ l̪ ɑ
груша	ɦ r u ʃ ɑ
системою	s̪ ɪ s̪ t̪ ɛ m ɔ u
громадського	ɦ r ɔ m ɑ d̪ s̪ k ɔ ɦ ɔ
ректор	r ɛ k t̪ ɔ r
толочиш	t̪ ɔ l̪ ɔ t̪ ʃ ɪ ʃ
неповоротких	n̪ ɛ p ɔ v ɔ r ɔ t̪ k ɪ x
своєрідний	s̪ v ɔ ɛ rʲ i d̪ n̪ ɪ j
виклик	v ɪ k l̪ ɪ k
Франка	f r ɑ n̪ k ɑ
суспільству	s̪ u s̪ p i lʲ s̪ t̪ v u
ранок	r ɑ n̪ ɔ k
збиралися	z̪ b ɪ r ɑ l̪ ɪ s̪ ɑ
заняття	z̪ ɑ n̪ʲ ɑ t̪ t̪ ɑ
керівники	k ɛ rʲ i v n̪ ɪ k ɪ
кримського	k r ɪ m s̪ k ɔ ɦ ɔ
обкому	ɔ b k ɔ m u
суді	s̪ u d̪ʲ i
створили	s̪ t̪ v ɔ r ɪ l̪ ɪ
Наша	n̪ ɑ ʃ ɑ
боролися	b ɔ r ɔ l̪ ɪ s̪ ɑ
незаконне	n̪ ɛ z̪ ɑ k ɔ n̪ n̪ ɛ
росіян	r ɔ s̪ i ɑ n̪
вівторка	v i v t̪ ɔ r k ɑ
четверту	t̪ ʃ ɛ t̪ v ɛ r t̪ u
дозволила	d̪ ɔ z̪ v ɔ l̪ ɪ l̪ ɑ
віз	v i z̪
нагороди	n̪ ɑ ɦ ɔ r ɔ d̪ ɪ
півсотні	p i v s̪ ɔ t̪ n̪ʲ i
школярів	ʃ k ɔ lʲ ɑ rʲ i v
радянської	r ɑ d̪ʲ ɑ n̪ s̪ k ɔ j i
державний	d̪ ɛ r ʒ ɑ v n̪ ɪ j
прапор	p r ɑ p ɔ r
рахунку	r ɑ x u n̪ k u
найближчим	n̪ ɑ j b l̪ ɪ ʒ t̪ ʃ ɪ m
партію	p ɑ r t̪ i u
нічим	n̪ʲ i t̪ ʃ ɪ m
капітан	k ɑ p i t̪ ɑ n̪
шахів	ʃ ɑ x i v
жили	ʒ ɪ l̪ ɪ
мама	m ɑ m ɑ
умовах	u m ɔ v ɑ x
зникнення	z̪ n̪ ɪ k n̪ ɛ n̪ n̪ʲ ɑ
встигли	v s̪ t̪ ɪ ɦ l̪ ɪ
результатами	r ɛ z̪ u lʲ t̪ ɑ t̪ ɑ m ɪ
чемпіонами	t̪ ʃ ɛ m p i ɔ n̪ ɑ m ɪ
десяти	d̪ ɛ s̪ ɑ t̪ ɪ
вагових	v ɑ ɦ ɔ v ɪ x
категоріях	k ɑ t̪ ɛ ɦ ɔ rʲ i ɑ x
нерідко	n̪ ɛ rʲ i d̪ k ɔ
посади	p ɔ s̪ ɑ d̪ ɪ
добро	d̪ ɔ b r ɔ
виробників	v ɪ r ɔ b n̪ ɪ k i v
дають	d̪ ɑ u t̪
казав	k ɑ z̪ ɑ v
громадянина	ɦ r ɔ m ɑ d̪ʲ ɑ n̪ ɪ n̪ ɑ
інтереси	i n̪ t̪ ɛ r ɛ s̪ ɪ
обласній	ɔ b l̪ ɑ s̪ n̪ʲ i j
бронзи	b r ɔ n̪ z̪ ɪ
тенденція	t̪ ɛ n̪ d̪ ɛ n̪ t̪s̪ʲ i ɑ
спостерігається	s̪ p ɔ s̪ t̪ ɛ rʲ i ɦ ɑ ɛ t̪ s̪ ɑ
нинішньої	n̪ ɪ n̪ʲ i ʃ n̪ʲ ɔ j i
замінити	z̪ ɑ m i n̪ ɪ t̪ ɪ
відбулися	v i d̪ b u l̪ ɪ s̪ ɑ
президента	p r ɛ z̪ ɪ d̪ ɛ n̪ t̪ ɑ
наслідком	n̪ ɑ s̪ lʲ i d̪ k ɔ m
ваше	v ɑ ʃ ɛ
світового	s̪ v i t̪ ɔ v ɔ ɦ ɔ
власного	v l̪ ɑ s̪ n̪ ɔ ɦ ɔ
закладів	z̪ ɑ k l̪ ɑ d̪ʲ i v
питай	p ɪ t̪ ɑ j
потенціалу	p ɔ t̪ ɛ n̪ t̪s̪ʲ i ɑ l̪ u
знань	z̪ n̪ ɑ n̪ʲ
оцінку	ɔ t̪s̪ʲ i n̪ k u
чоловіків	t̪ ʃ ɔ l̪ ɔ v i k i v
тест	t̪ ɛ s̪ t̪
підтримувати	p i d̪ t̪ r ɪ m u v ɑ t̪ ɪ
мінус	m i n̪ u s̪
плюс	p lʲ u s̪
Верховної	v ɛ r x ɔ v n̪ ɔ j i
пропозицією	p r ɔ p ɔ z̪ ɪ t̪s̪ʲ i ɛ u
процедури	p r ɔ t̪s̪ ɛ d̪ u r ɪ
проводять	p r ɔ v ɔ d̪ʲ ɑ t̪
кроків	k r ɔ k i v
Швейцарії	ʃ v ɛ j t̪s̪ ɑ rʲ i j i
зв'язки	z̪ v j ɑ z̪ k ɪ
пишається	p ɪ ʃ ɑ ɛ t̪ s̪ ɑ
випередив	v ɪ p ɛ r ɛ d̪ ɪ v
гонці	ɦ ɔ n̪ t̪s̪ʲ i
глибині	ɦ l̪ ɪ b ɪ n̪ʲ i
метрів	m ɛ t̪ rʲ i v
місць	m i s̪ t̪s̪ʲ
думати	d̪ u m ɑ t̪ ɪ
тримати	t̪ r ɪ m ɑ t̪ ɪ
тривають	t̪ r ɪ v ɑ u t̪
поруч	p ɔ r u t̪ ʃ
теракт	t̪ ɛ r ɑ k t̪
Єрусалимі	j ɛ r u s̪ ɑ l̪ ɪ m i
повернеться	p ɔ v ɛ r n̪ ɛ t̪ s̪ ɑ
серці	s̪ ɛ r t̪s̪ʲ i
легше	l̪ ɛ ɦ ʃ ɛ
Українська	u k r ɑ j i n̪ s̪ k ɑ
провідних	p r ɔ v i d̪ n̪ ɪ x
письменників	p ɪ s̪ m ɛ n̪ n̪ ɪ k i v
митців	m ɪ t̪ t̪s̪ʲ i v
складу	s̪ k l̪ ɑ d̪ u
відпочинку	v i d̪ p ɔ t̪ ʃ ɪ n̪ k u
іще	i ʃ t̪ ʃ ɛ
збір	z̪ b i r
даних	d̪ ɑ n̪ ɪ x
почався	p ɔ t̪ ʃ ɑ v s̪ ɑ
війну	v i j n̪ u
впродовж	v p r ɔ d̪ ɔ v ʒ
селищі	s̪ ɛ l̪ ɪ ʃ t̪ ʃ i
приватних	p r ɪ v ɑ t̪ n̪ ɪ x
підприємців	p i d̪ p r ɪ ɛ m t̪s̪ʲ i v
політична	p ɔ lʲ i t̪ ɪ t̪ ʃ n̪ ɑ
виніс	v ɪ n̪ʲ i s̪
комори	k ɔ m ɔ r ɪ
мішки	m i ʃ k ɪ
поклав	p ɔ k l̪ ɑ v
контракти	k ɔ n̪ t̪ r ɑ k t̪ ɪ
майбутнього	m ɑ j b u t̪ n̪ʲ ɔ ɦ ɔ
людьми	lʲ u d̪ʲ m ɪ
необхідності	n̪ ɛ ɔ b x i d̪ n̪ ɔ s̪ t̪ i
розжарене	r ɔ z̪ ʒ ɑ r ɛ n̪ ɛ
містом	m i s̪ t̪ ɔ m
висить	v ɪ s̪ ɪ t̪
починає	p ɔ t̪ ʃ ɪ n̪ ɑ ɛ
кадрів	k ɑ d̪ rʲ i v
судовий	s̪ u d̪ ɔ v ɪ j
потупивши	p ɔ t̪ u p ɪ v ʃ ɪ
сільське	s̪ i lʲ s̪ k ɛ
господарство	ɦ ɔ s̪ p ɔ d̪ ɑ r s̪ t̪ v ɔ
тваринництва	t̪ v ɑ r ɪ n̪ n̪ ɪ t̪s̪ t̪ v ɑ
валютному	v ɑ lʲ u t̪ n̪ ɔ m u
Лукашенко	l̪ u k ɑ ʃ ɛ n̪ k ɔ
боїться	b ɔ j i t̪ s̪ ɑ
фільмі	f i lʲ m i
розраховувати	r ɔ z̪ r ɑ x ɔ v u v ɑ t̪ ɪ
тарифи	t̪ ɑ r ɪ f ɪ
врожаю	v r ɔ ʒ ɑ u
повернули	p ɔ v ɛ r n̪ u l̪ ɪ
почула	p ɔ t̪ ʃ u l̪ ɑ
лиця	l̪ ɪ t̪s̪ʲ ɑ
красується	k r ɑ s̪ u ɛ t̪ s̪ ɑ
розкішнім	r ɔ z̪ k i ʃ n̪ʲ i m
убранні	u b r ɑ n̪ n̪ʲ i
рекорд	r ɛ k ɔ r d̪
розглядає	r ɔ z̪ ɦ lʲ ɑ d̪ ɑ ɛ
побачте	p ɔ b ɑ t̪ ʃ t̪ ɛ
першими	p ɛ r ʃ ɪ m ɪ
болід	b ɔ lʲ i d̪
Мерседеса	m ɛ r s̪ ɛ d̪ ɛ s̪ ɑ
Вінниччині	v i n̪ n̪ ɪ t̪ ʃ t̪ ʃ ɪ n̪ʲ i
запропонувала	z̪ ɑ p r ɔ p ɔ n̪ u v ɑ l̪ ɑ
соціальної	s̪ ɔ t̪s̪ʲ i ɑ lʲ n̪ ɔ j i
передано	p ɛ r ɛ d̪ ɑ n̪ ɔ
розгляд	r ɔ z̪ ɦ lʲ ɑ d̪
Міністерство	m i n̪ʲ i s̪ t̪ ɛ r s̪ t̪ v ɔ
ситуацій	s̪ ɪ t̪ u ɑ t̪s̪ʲ i j
молодь	m ɔ l̪ ɔ d̪ʲ
незалежної	n̪ ɛ z̪ ɑ l̪ ɛ ʒ n̪ ɔ j i
Академії	ɑ k ɑ d̪ ɛ m i j i
сиділи	s̪ ɪ d̪ʲ i l̪ ɪ
полу	p ɔ l̪ u
написала	n̪ ɑ p ɪ s̪ ɑ l̪ ɑ
клуб	k l̪ u b
справами	s̪ p r ɑ v ɑ m ɪ
минув	m ɪ n̪ u v
минає	m ɪ n̪ ɑ ɛ
дало	d̪ ɑ l̪ ɔ
померли	p ɔ m ɛ r l̪ ɪ
півночі	p i v n̪ ɔ t̪ ʃ i
Німеччини	n̪ʲ i m ɛ t̪ ʃ t̪ ʃ ɪ n̪ ɪ
видобуток	v ɪ d̪ ɔ b u t̪ ɔ k
сланцевого	s̪ l̪ ɑ n̪ t̪s̪ ɛ v ɔ ɦ ɔ
живемо	ʒ ɪ v ɛ m ɔ
непогано	n̪ ɛ p ɔ ɦ ɑ n̪ ɔ
провів	p r ɔ v i v
турнір	t̪ u r n̪ʲ i r
сидить	s̪ ɪ d̪ ɪ t̪
вивчати	v ɪ v t̪ ʃ ɑ t̪ ɪ
стараюсь	s̪ t̪ ɑ r ɑ u s̪
дивитись	d̪ ɪ v ɪ t̪ ɪ s̪
засмаглих	z̪ ɑ s̪ m ɑ ɦ l̪ ɪ x
нинішні	n̪ ɪ n̪ʲ i ʃ n̪ʲ i
вельми	v ɛ lʲ m ɪ
родині	r ɔ d̪ ɪ n̪ʲ i
лікарі	lʲ i k ɑ rʲ i
життю	ʒ ɪ t̪ t̪ u
жертви	ʒ ɛ r t̪ v ɪ
інфекції	i n̪ f ɛ k t̪s̪ʲ i j i
тройко	t̪ r ɔ j k ɔ
похмурі	p ɔ x m u rʲ i
невеселі	n̪ ɛ v ɛ s̪ ɛ lʲ i
відпустка	v i d̪ p u s̪ t̪ k ɑ
жовтні	ʒ ɔ v t̪ n̪ʲ i
зима	z̪ ɪ m ɑ
наказ	n̪ ɑ k ɑ z̪
брав	b r ɑ v
Сочі	s̪ ɔ t̪ ʃ i
офіційно	ɔ f i t̪s̪ʲ i j n̪ ɔ
Далгліш	d̪ ɑ l̪ ɦ lʲ i ʃ
трофеєм	t̪ r ɔ f ɛ ɛ m
періоду	p ɛ rʲ i ɔ d̪ u
стільчику	s̪ t̪ i lʲ t̪ ʃ ɪ k u
неясно	n̪ ɛ ɑ s̪ n̪ ɔ
блимав	b l̪ ɪ m ɑ v
каганець	k ɑ ɦ ɑ n̪ ɛ t̪s̪ʲ
безкрає	b ɛ z̪ k r ɑ ɛ
зглянеш	z̪ ɦ lʲ ɑ n̪ ɛ ʃ
колектив	k ɔ l̪ ɛ k t̪ ɪ v
Дзеркало	d̪ z̪ ɛ r k ɑ l̪ ɔ
надалі	n̪ ɑ d̪ ɑ lʲ i
знов	z̪ n̪ ɔ v
холодних	x ɔ l̪ ɔ d̪ n̪ ɪ x
середнього	s̪ ɛ r ɛ d̪ n̪ʲ ɔ ɦ ɔ
багатьом	b ɑ ɦ ɑ t̪ ɔ m
звідти	z̪ v i d̪ t̪ ɪ
газовий	ɦ ɑ z̪ ɔ v ɪ j
прийняв	p r ɪ j n̪ʲ ɑ v
квотування	k v ɔ t̪ u v ɑ n̪ n̪ʲ ɑ
національні	n̪ ɑ t̪s̪ʲ i ɔ n̪ ɑ lʲ n̪ʲ i
питає	p ɪ t̪ ɑ ɛ
писаря	p ɪ s̪ ɑ rʲ ɑ
чаду	t̪ ʃ ɑ d̪ u
кругом	k r u ɦ ɔ m
господарів	ɦ ɔ s̪ p ɔ d̪ ɑ rʲ i v
удома	u d̪ ɔ m ɑ
чутки	t̪ ʃ u t̪ k ɪ
письменником	p ɪ s̪ m ɛ n̪ n̪ ɪ k ɔ m
політичний	p ɔ lʲ i t̪ ɪ t̪ ʃ n̪ ɪ j
оступився	ɔ s̪ t̪ u p ɪ v s̪ ɑ
ступені	s̪ t̪ u p ɛ n̪ʲ i
стола	s̪ t̪ ɔ l̪ ɑ
непорушно	n̪ ɛ p ɔ r u ʃ n̪ ɔ
неначе	n̪ ɛ n̪ ɑ t̪ ʃ ɛ
скеля	s̪ k ɛ lʲ ɑ
крейда	k r ɛ j d̪ ɑ
власним	v l̪ ɑ s̪ n̪ ɪ m
бажанням	b ɑ ʒ ɑ n̪ n̪ʲ ɑ m
листи	l̪ ɪ s̪ t̪ ɪ
сталінських	s̪ t̪ ɑ lʲ i n̪ s̪ k ɪ x
таборів	t̪ ɑ b ɔ rʲ i v
еміграції	ɛ m i ɦ r ɑ t̪s̪ʲ i j i
вкрай	v k r ɑ j
досліджень	d̪ ɔ s̪ lʲ i d̪ ʒ ɛ n̪ʲ
університету	u n̪ʲ i v ɛ r s̪ ɪ t̪ ɛ t̪ u
хлопець	x l̪ ɔ p ɛ t̪s̪ʲ
Володимира	v ɔ l̪ ɔ d̪ ɪ m ɪ r ɑ
мешкають	m ɛ ʃ k ɑ u t̪
відмовилися	v i d̪ m ɔ v ɪ l̪ ɪ s̪ ɑ
виставка	v ɪ s̪ t̪ ɑ v k ɑ
Григорій	ɦ r ɪ ɦ ɔ rʲ i j
Сковорода	s̪ k ɔ v ɔ r ɔ d̪ ɑ
літературу	lʲ i t̪ ɛ r ɑ t̪ u r u
різного	rʲ i z̪ n̪ ɔ ɦ ɔ
тато	t̪ ɑ t̪ ɔ
дозволити	d̪ ɔ z̪ v ɔ l̪ ɪ t̪ ɪ
пити	p ɪ t̪ ɪ
зобов'язань	z̪ ɔ b ɔ v j ɑ z̪ ɑ n̪ʲ
свободи	s̪ v ɔ b ɔ d̪ ɪ
журналістики	ʒ u r n̪ ɑ lʲ i s̪ t̪ ɪ k ɪ
парламенту	p ɑ r l̪ ɑ m ɛ n̪ t̪ u
комуністичної	k ɔ m u n̪ʲ i s̪ t̪ ɪ t̪ ʃ n̪ ɔ j i
промах	p r ɔ m ɑ x
економічних	ɛ k ɔ n̪ ɔ m i t̪ ʃ n̪ ɪ x
політичних	p ɔ lʲ i t̪ ɪ t̪ ʃ n̪ ɪ x
заважає	z̪ ɑ v ɑ ʒ ɑ ɛ
спеціальні	s̪ p ɛ t̪s̪ʲ i ɑ lʲ n̪ʲ i
візити	v i z̪ ɪ t̪ ɪ
вдвічі	v d̪ v i t̪ ʃ i
керівництва	k ɛ rʲ i v n̪ ɪ t̪s̪ t̪ v ɑ
підеш	p i d̪ ɛ ʃ
визначила	v ɪ z̪ n̪ ɑ t̪ ʃ ɪ l̪ ɑ
господарства	ɦ ɔ s̪ p ɔ d̪ ɑ r s̪ t̪ v ɑ
середньої	s̪ ɛ r ɛ d̪ n̪ʲ ɔ j i
посад	p ɔ s̪ ɑ d̪
Шуфрич	ʃ u f r ɪ t̪ ʃ
якість	j ɑ k i s̪ t̪
інтелігенції	i n̪ t̪ ɛ lʲ i ɦ ɛ n̪ t̪s̪ʲ i j i
половині	p ɔ l̪ ɔ v ɪ n̪ʲ i
зниження	z̪ n̪ ɪ ʒ ɛ n̪ n̪ʲ ɑ
другій	d̪ r u ɦ i j
шанси	ʃ ɑ n̪ s̪ ɪ
Яценюк	j ɑ t̪s̪ ɛ n̪ʲ u k
дитині	d̪ ɪ t̪ ɪ n̪ʲ i
Нацбанк	n̪ ɑ t̪s̪ b ɑ n̪ k
прибуток	p r ɪ b u t̪ ɔ k
розпочато	r ɔ z̪ p ɔ t̪ ʃ ɑ t̪ ɔ
синхронних	s̪ ɪ n̪ x r ɔ n̪ n̪ ɪ x
стрибках	s̪ t̪ r ɪ b k ɑ x
вибороли	v ɪ b ɔ r ɔ l̪ ɪ
срібло	s̪ rʲ i b l̪ ɔ
Чемпіонат	t̪ ʃ ɛ m p i ɔ n̪ ɑ t̪
Ради	r ɑ d̪ ɪ
позбутися	p ɔ z̪ b u t̪ ɪ s̪ ɑ
залежності	z̪ ɑ l̪ ɛ ʒ n̪ ɔ s̪ t̪ i
великих	v ɛ l̪ ɪ k ɪ x
Сегодня	s̪ ɛ ɦ ɔ d̪ n̪ʲ ɑ
посиланням	p ɔ s̪ ɪ l̪ ɑ n̪ n̪ʲ ɑ m
МЗС	m z̪ s̪
соціальних	s̪ ɔ t̪s̪ʲ i ɑ lʲ n̪ ɪ x
вірить	v i r ɪ t̪
платять	p l̪ ɑ t̪ ɑ t̪
нікому	n̪ʲ i k ɔ m u
Іванчук	i v ɑ n̪ t̪ ʃ u k
змінив	z̪ m i n̪ ɪ v
шахи	ʃ ɑ x ɪ
слідства	s̪ lʲ i d̪ s̪ t̪ v ɑ
списку	s̪ p ɪ s̪ k u
кому	k ɔ m u
однаково	ɔ d̪ n̪ ɑ k ɔ v ɔ
Ющенка	j u ʃ t̪ ʃ ɛ n̪ k ɑ
тур	t̪ u r
вважали	v v ɑ ʒ ɑ l̪ ɪ
Японії	j ɑ p ɔ n̪ʲ i j i
давати	d̪ ɑ v ɑ t̪ ɪ
серйозних	s̪ ɛ r j ɔ z̪ n̪ ɪ x
європейський	j ɛ v r ɔ p ɛ j s̪ k ɪ j
команду	k ɔ m ɑ n̪ d̪ u
припинити	p r ɪ p ɪ n̪ ɪ t̪ ɪ
продаж	p r ɔ d̪ ɑ ʒ
неповнолітніх	n̪ ɛ p ɔ v n̪ ɔ lʲ i t̪ n̪ʲ i x
якісь	j ɑ k i s̪
нинішнього	n̪ ɪ n̪ʲ i ʃ n̪ʲ ɔ ɦ ɔ
майна	m ɑ j n̪ ɑ
земельних	z̪ ɛ m ɛ lʲ n̪ ɪ x
питань	p ɪ t̪ ɑ n̪ʲ
запечених	z̪ ɑ p ɛ t̪ ʃ ɛ n̪ ɪ x
сонцем	s̪ ɔ n̪ t̪s̪ ɛ m
високих	v ɪ s̪ ɔ k ɪ x
виступ	v ɪ s̪ t̪ u p
успіх	u s̪ p i x
Маріуполі	m ɑ rʲ i u p ɔ lʲ i
п'ятнадцять	p j ɑ t̪ n̪ ɑ d̪ t̪s̪ʲ ɑ t̪
спільнота	s̪ p i lʲ n̪ ɔ t̪ ɑ
дозволить	d̪ ɔ z̪ v ɔ l̪ ɪ t̪
повному	p ɔ v n̪ ɔ m u
обсязі	ɔ b s̪ ɑ z̪ʲ i
фінансувати	f i n̪ ɑ n̪ s̪ u v ɑ t̪ ɪ
соціальні	s̪ ɔ t̪s̪ʲ i ɑ lʲ n̪ʲ i
видатки	v ɪ d̪ ɑ t̪ k ɪ
практика	p r ɑ k t̪ ɪ k ɑ
виступає	v ɪ s̪ t̪ u p ɑ ɛ
своїй	s̪ v ɔ j i j
четверте	t̪ ʃ ɛ t̪ v ɛ r t̪ ɛ
Ужгороді	u ʒ ɦ ɔ r ɔ d̪ʲ i
дванадцята	d̪ v ɑ n̪ ɑ d̪ t̪s̪ʲ ɑ t̪ ɑ
створив	s̪ t̪ v ɔ r ɪ v
службу	s̪ l̪ u ʒ b u
обізвалась	ɔ b i z̪ v ɑ l̪ ɑ s̪
довкола	d̪ ɔ v k ɔ l̪ ɑ
зайшов	z̪ ɑ j ʃ ɔ v
столу	s̪ t̪ ɔ l̪ u
пора	p ɔ r ɑ
ідіть	i d̪ʲ i t̪
рвіть	r v i t̪
сміливо	s̪ m i l̪ ɪ v ɔ
музеї	m u z̪ ɛ j i
Тернополя	t̪ ɛ r n̪ ɔ p ɔ lʲ ɑ
шести	ʃ ɛ s̪ t̪ ɪ
фінансові	f i n̪ ɑ n̪ s̪ ɔ v i
вести	v ɛ s̪ t̪ ɪ
складається	s̪ k l̪ ɑ d̪ ɑ ɛ t̪ s̪ ɑ
місяців	m i s̪ ɑ t̪s̪ʲ i v
німецької	n̪ʲ i m ɛ t̪s̪ʲ k ɔ j i
повноваження	p ɔ v n̪ ɔ v ɑ ʒ ɛ n̪ n̪ʲ ɑ
обидві	ɔ b ɪ d̪ v i
схід	s̪ x i d̪
молодіжних	m ɔ l̪ ɔ d̪ʲ i ʒ n̪ ɪ x
оцінки	ɔ t̪s̪ʲ i n̪ k ɪ
Криму	k r ɪ m u
частиною	t̪ ʃ ɑ s̪ t̪ ɪ n̪ ɔ u
російського	r ɔ s̪ i j s̪ k ɔ ɦ ɔ
пан	p ɑ n̪
Арбузов	ɑ r b u z̪ ɔ v
Москва	m ɔ s̪ k v ɑ
позицій	p ɔ z̪ ɪ t̪s̪ʲ i j
викликають	v ɪ k l̪ ɪ k ɑ u t̪
сину	s̪ ɪ n̪ u
почував	p ɔ t̪ ʃ u v ɑ v
прокидалось	p r ɔ k ɪ d̪ ɑ l̪ ɔ s̪
невідоме	n̪ ɛ v i d̪ ɔ m ɛ
чудне	t̪ ʃ u d̪ n̪ ɛ
бував	b u v ɑ v
прохання	p r ɔ x ɑ n̪ n̪ʲ ɑ
захищає	z̪ ɑ x ɪ ʃ t̪ ʃ ɑ ɛ
наміри	n̪ ɑ m i r ɪ
Євро	j ɛ v r ɔ
дванадцять	d̪ v ɑ n̪ ɑ d̪ t̪s̪ʲ ɑ t̪
представлено	p r ɛ d̪ s̪ t̪ ɑ v l̪ ɛ n̪ ɔ
шістнадцять	ʃ i s̪ t̪ n̪ ɑ d̪ t̪s̪ʲ ɑ t̪
запрошує	z̪ ɑ p r ɔ ʃ u ɛ
виникнення	v ɪ n̪ ɪ k n̪ ɛ n̪ n̪ʲ ɑ
створила	s̪ t̪ v ɔ r ɪ l̪ ɑ
Великобританії	v ɛ l̪ ɪ k ɔ b r ɪ t̪ ɑ n̪ʲ i j i
нігде	n̪ʲ i ɦ d̪ ɛ
пристати	p r ɪ s̪ t̪ ɑ t̪ ɪ
зачепитися	z̪ ɑ t̪ ʃ ɛ p ɪ t̪ ɪ s̪ ɑ
обговорення	ɔ b ɦ ɔ v ɔ r ɛ n̪ n̪ʲ ɑ
справжню	s̪ p r ɑ v ʒ n̪ʲ u
звертається	z̪ v ɛ r t̪ ɑ ɛ t̪ s̪ ɑ
увага	u v ɑ ɦ ɑ
їсти	j i s̪ t̪ ɪ
енергоносії	ɛ n̪ ɛ r ɦ ɔ n̪ ɔ s̪ i j i
електроенергію	ɛ l̪ ɛ k t̪ r ɔ ɛ n̪ ɛ r ɦ i u
зростали	z̪ r ɔ s̪ t̪ ɑ l̪ ɪ
Черкас	t̪ ʃ ɛ r k ɑ s̪
борги	b ɔ r ɦ ɪ
міністрів	m i n̪ʲ i s̪ t̪ rʲ i v
комісарів	k ɔ m i s̪ ɑ rʲ i v
черговий	t̪ ʃ ɛ r ɦ ɔ v ɪ j
свіжий	s̪ v i ʒ ɪ j
сніг	s̪ n̪ʲ i ɦ
укрив	u k r ɪ v
долини	d̪ ɔ l̪ ɪ n̪ ɪ
тонким	t̪ ɔ n̪ k ɪ m
дорогим	d̪ ɔ r ɔ ɦ ɪ m
полотном	p ɔ l̪ ɔ t̪ n̪ ɔ m
окремо	ɔ k r ɛ m ɔ
церков	t̪s̪ ɛ r k ɔ v
біліло	b i lʲ i l̪ ɔ
місцевій	m i s̪ t̪s̪ ɛ v i j
пресі	p r ɛ s̪ i
добрі	d̪ ɔ b rʲ i
Урядовий	u rʲ ɑ d̪ ɔ v ɪ j
кур'єр	k u r j ɛ r
спорті	s̪ p ɔ r t̪ i
співчуття	s̪ p i v t̪ ʃ u t̪ t̪ ɑ
власний	v l̪ ɑ s̪ n̪ ɪ j
біль	b i lʲ
сорочка	s̪ ɔ r ɔ t̪ ʃ k ɑ
Олександр	ɔ l̪ ɛ k s̪ ɑ n̪ d̪ r
українцям	u k r ɑ j i n̪ t̪s̪ʲ ɑ m
мішків	m i ʃ k i v
гречаної	ɦ r ɛ t̪ ʃ ɑ n̪ ɔ j i
вовни	v ɔ v n̪ ɪ
сподіватися	s̪ p ɔ d̪ʲ i v ɑ t̪ ɪ s̪ ɑ
доброго	d̪ ɔ b r ɔ ɦ ɔ
спитати	s̪ p ɪ t̪ ɑ t̪ ɪ
золото	z̪ ɔ l̪ ɔ t̪ ɔ
тата	t̪ ɑ t̪ ɑ
люблю	lʲ u b lʲ u
тожто	t̪ ɔ ʒ t̪ ɔ
січня	s̪ i t̪ ʃ n̪ʲ ɑ
розумію	r ɔ z̪ u m i u
стиль	s̪ t̪ ɪ lʲ
мусить	m u s̪ ɪ t̪
сторін	s̪ t̪ ɔ rʲ i n̪
долі	d̪ ɔ lʲ i
політикою	p ɔ lʲ i t̪ ɪ k ɔ u
підтвердив	p i d̪ t̪ v ɛ r d̪ ɪ v
квартиру	k v ɑ r t̪ ɪ r u
самим	s̪ ɑ m ɪ m
уступила	u s̪ t̪ u p ɪ l̪ ɑ
певна	p ɛ v n̪ ɑ
тобою	t̪ ɔ b ɔ u
надходження	n̪ ɑ d̪ x ɔ d̪ ʒ ɛ n̪ n̪ʲ ɑ
стилі	s̪ t̪ ɪ lʲ i
втратили	v t̪ r ɑ t̪ ɪ l̪ ɪ
навантаження	n̪ ɑ v ɑ n̪ t̪ ɑ ʒ ɛ n̪ n̪ʲ ɑ
останньої	ɔ s̪ t̪ ɑ n̪ n̪ʲ ɔ j i
копійки	k ɔ p i j k ɪ
значні	z̪ n̪ ɑ t̪ ʃ n̪ʲ i
зможуть	z̪ m ɔ ʒ u t̪
сцені	s̪ t̪s̪ ɛ n̪ʲ i
бити	b ɪ t̪ ɪ
закликав	z̪ ɑ k l̪ ɪ k ɑ v
спільно	s̪ p i lʲ n̪ ɔ
Карпатах	k ɑ r p ɑ t̪ ɑ x
тіла	t̪ i l̪ ɑ
ознак	ɔ z̪ n̪ ɑ k
великою	v ɛ l̪ ɪ k ɔ u
половина	p ɔ l̪ ɔ v ɪ n̪ ɑ
їхньої	j i x n̪ʲ ɔ j i
двома	d̪ v ɔ m ɑ
медиків	m ɛ d̪ ɪ k i v
звинувачують	z̪ v ɪ n̪ u v ɑ t̪ ʃ u u t̪
здатна	z̪ d̪ ɑ t̪ n̪ ɑ
номером	n̪ ɔ m ɛ r ɔ m
змогла	z̪ m ɔ ɦ l̪ ɑ
реальної	r ɛ ɑ lʲ n̪ ɔ j i
Баттон	b ɑ t̪ t̪ ɔ n̪
фінішував	f i n̪ʲ i ʃ u v ɑ v
третім	t̪ r ɛ t̪ i m
намалюю	n̪ ɑ m ɑ lʲ u u
вітаютой	v i t̪ ɑ u t̪ ɔ j
співаю	s̪ p i v ɑ u
складних	s̪ k l̪ ɑ d̪ n̪ ɪ x
приватизації	p r ɪ v ɑ t̪ ɪ z̪ ɑ t̪s̪ʲ i j i
промисловості	p r ɔ m ɪ s̪ l̪ ɔ v ɔ s̪ t̪ i
щаслива	ʃ t̪ ʃ ɑ s̪ l̪ ɪ v ɑ
найбільше	n̪ ɑ j b i lʲ ʃ ɛ
реалізації	r ɛ ɑ lʲ i z̪ ɑ t̪s̪ʲ i j i
іноземні	i n̪ ɔ z̪ ɛ m n̪ʲ i
інвестори	i n̪ v ɛ s̪ t̪ ɔ r ɪ
Міністерстві	m i n̪ʲ i s̪ t̪ ɛ r s̪ t̪ v i
причину	p r ɪ t̪ ʃ ɪ n̪ u
золота	z̪ ɔ l̪ ɔ t̪ ɑ
правління	p r ɑ v lʲ i n̪ n̪ʲ ɑ
Пенсійного	p ɛ n̪ s̪ i j n̪ ɔ ɦ ɔ
власними	v l̪ ɑ s̪ n̪ ɪ m ɪ
руками	r u k ɑ m ɪ
Леся	l̪ ɛ s̪ ɑ
Львова	lʲ v ɔ v ɑ
станом	s̪ t̪ ɑ n̪ ɔ m
відмову	v i d̪ m ɔ v u
прожиткового	p r ɔ ʒ ɪ t̪ k ɔ v ɔ ɦ ɔ
мінімуму	m i n̪ʲ i m u m u
діалог	d̪ʲ i ɑ l̪ ɔ ɦ
вугілля	v u ɦ i l̪ lʲ ɑ
шістнадцята	ʃ i s̪ t̪ n̪ ɑ d̪ t̪s̪ʲ ɑ t̪ ɑ
другі	d̪ r u ɦ i
Наталя	n̪ ɑ t̪ ɑ lʲ ɑ
Рівному	rʲ i v n̪ ɔ m u
пріоритетних	p rʲ i ɔ r ɪ t̪ ɛ t̪ n̪ ɪ x
галузей	ɦ ɑ l̪ u z̪ ɛ j
невідомих	n̪ ɛ v i d̪ ɔ m ɪ x
політичне	p ɔ lʲ i t̪ ɪ t̪ ʃ n̪ ɛ
ніякого	n̪ʲ i ɑ k ɔ ɦ ɔ
дому	d̪ ɔ m u
потреба	p ɔ t̪ r ɛ b ɑ
майстра	m ɑ j s̪ t̪ r ɑ
отримував	ɔ t̪ r ɪ m u v ɑ v
відповідних	v i d̪ p ɔ v i d̪ n̪ ɪ x
повноважень	p ɔ v n̪ ɔ v ɑ ʒ ɛ n̪ʲ
Петра	p ɛ t̪ r ɑ
дивлячись	d̪ ɪ v lʲ ɑ t̪ ʃ ɪ s̪
телвізор	t̪ ɛ l̪ v i z̪ ɔ r
п'ятнадцяти	p j ɑ t̪ n̪ ɑ d̪ t̪s̪ʲ ɑ t̪ ɪ
десята	d̪ ɛ s̪ ɑ t̪ ɑ
писали	p ɪ s̪ ɑ l̪ ɪ
почало	p ɔ t̪ ʃ ɑ l̪ ɔ
бий	b ɪ j
божа	b ɔ ʒ ɑ
ярмарок	j ɑ r m ɑ r ɔ k
нащо	n̪ ɑ ʃ t̪ ʃ ɔ
Лізі	lʲ i z̪ʲ i
Чемпіонів	t̪ ʃ ɛ m p i ɔ n̪ʲ i v
найкраща	n̪ ɑ j k r ɑ ʃ t̪ ʃ ɑ
принципів	p r ɪ n̪ t̪s̪ ɪ p i v
Генпрокуратурі	ɦ ɛ n̪ p r ɔ k u r ɑ t̪ u rʲ i
ремонт	r ɛ m ɔ n̪ t̪
машини	m ɑ ʃ ɪ n̪ ɪ
автомобіля	ɑ v t̪ ɔ m ɔ b i lʲ ɑ
просили	p r ɔ s̪ ɪ l̪ ɪ
тисячу	t̪ ɪ s̪ ɑ t̪ ʃ u
прийняли	p r ɪ j n̪ʲ ɑ l̪ ɪ
Донецької	d̪ ɔ n̪ ɛ t̪s̪ʲ k ɔ j i
покарання	p ɔ k ɑ r ɑ n̪ n̪ʲ ɑ
вистачить	v ɪ s̪ t̪ ɑ t̪ ʃ ɪ t̪
зусилля	z̪ u s̪ ɪ l̪ lʲ ɑ
принесли	p r ɪ n̪ ɛ s̪ l̪ ɪ
професію	p r ɔ f ɛ s̪ i u
вчителя	v t̪ ʃ ɪ t̪ ɛ lʲ ɑ
маючи	m ɑ u t̪ ʃ ɪ
дивиться	d̪ ɪ v ɪ t̪ s̪ ɑ
байдуже	b ɑ j d̪ u ʒ ɛ
Федерації	f ɛ d̪ ɛ r ɑ t̪s̪ʲ i j i
матеріалів	m ɑ t̪ ɛ rʲ i ɑ lʲ i v
УМ	u m
допомагають	d̪ ɔ p ɔ m ɑ ɦ ɑ u t̪
Сумах	s̪ u m ɑ x
квітні	k v i t̪ n̪ʲ i
засідання	z̪ ɑ s̪ i d̪ ɑ n̪ n̪ʲ ɑ
школу	ʃ k ɔ l̪ u
темі	t̪ ɛ m i
потрапить	p ɔ t̪ r ɑ p ɪ t̪
пастку	p ɑ s̪ t̪ k u
Карпати	k ɑ r p ɑ t̪ ɪ
заява	z̪ ɑ ɑ v ɑ
земель	z̪ ɛ m ɛ lʲ
інколи	i n̪ k ɔ l̪ ɪ
кожний	k ɔ ʒ n̪ ɪ j
перейматися	p ɛ r ɛ j m ɑ t̪ ɪ s̪ ɑ
проживає	p r ɔ ʒ ɪ v ɑ ɛ
немало	n̪ ɛ m ɑ l̪ ɔ
писар	p ɪ s̪ ɑ r
поділитися	p ɔ d̪ʲ i l̪ ɪ t̪ ɪ s̪ ɑ
парубків	p ɑ r u b k i v
густо	ɦ u s̪ t̪ ɔ
зустріти	z̪ u s̪ t̪ rʲ i t̪ ɪ
хуторах	x u t̪ ɔ r ɑ x
минуле	m ɪ n̪ u l̪ ɛ
нещодавно	n̪ ɛ ʃ t̪ ʃ ɔ d̪ ɑ v n̪ ɔ
ініціативи	i n̪ʲ i t̪s̪ʲ i ɑ t̪ ɪ v ɪ
керівника	k ɛ rʲ i v n̪ ɪ k ɑ
втрачає	v t̪ r ɑ t̪ ʃ ɑ ɛ
вітри	v i t̪ r ɪ
дощем	d̪ ɔ ʃ t̪ ʃ ɛ m
лізуть	lʲ i z̪ u t̪
клопоти	k l̪ ɔ p ɔ t̪ ɪ
органи	ɔ r ɦ ɑ n̪ ɪ
гляди	ɦ lʲ ɑ d̪ ɪ
лишень	l̪ ɪ ʃ ɛ n̪ʲ
родич	r ɔ d̪ ɪ t̪ ʃ
товар	t̪ ɔ v ɑ r
категорично	k ɑ t̪ ɛ ɦ ɔ r ɪ t̪ ʃ n̪ ɔ
конфлікт	k ɔ n̪ f lʲ i k t̪
Світової	s̪ v i t̪ ɔ v ɔ j i
пасажирів	p ɑ s̪ ɑ ʒ ɪ rʲ i v
годиннику	ɦ ɔ d̪ ɪ n̪ n̪ ɪ k u
дев'ять	d̪ ɛ v j ɑ t̪
брата	b r ɑ t̪ ɑ
поспішають	p ɔ s̪ p i ʃ ɑ u t̪
твору	t̪ v ɔ r u
сирітське	s̪ ɪ rʲ i t̪ s̪ k ɛ
селом	s̪ ɛ l̪ ɔ m
лице	l̪ ɪ t̪s̪ ɛ
поту	p ɔ t̪ u
державному	d̪ ɛ r ʒ ɑ v n̪ ɔ m u
основні	ɔ s̪ n̪ ɔ v n̪ʲ i
стандарти	s̪ t̪ ɑ n̪ d̪ ɑ r t̪ ɪ
існувати	i s̪ n̪ u v ɑ t̪ ɪ
подумав	p ɔ d̪ u m ɑ v
свідченням	s̪ v i d̪ t̪ ʃ ɛ n̪ n̪ʲ ɑ m
Черкасах	t̪ ʃ ɛ r k ɑ s̪ ɑ x
повези	p ɔ v ɛ z̪ ɪ
асфальту	ɑ s̪ f ɑ lʲ t̪ u
Ахметов	ɑ x m ɛ t̪ ɔ v
піду	p i d̪ u
зняли	z̪ n̪ʲ ɑ l̪ ɪ
кандидатів	k ɑ n̪ d̪ ɪ d̪ ɑ t̪ i v
опозиції	ɔ p ɔ z̪ ɪ t̪s̪ʲ i j i
раптом	r ɑ p t̪ ɔ m
рух	r u x
фестиваль	f ɛ s̪ t̪ ɪ v ɑ lʲ
поранені	p ɔ r ɑ n̪ ɛ n̪ʲ i
п'ятнадцяте	p j ɑ t̪ n̪ ɑ d̪ t̪s̪ʲ ɑ t̪ ɛ
мільйона	m i lʲ j ɔ n̪ ɑ
цеху	t̪s̪ ɛ x u
рядки	rʲ ɑ d̪ k ɪ
доставили	d̪ ɔ s̪ t̪ ɑ v ɪ l̪ ɪ
обласної	ɔ b l̪ ɑ s̪ n̪ ɔ j i
дитячої	d̪ ɪ t̪ ɑ t̪ ʃ ɔ j i
поставок	p ɔ s̪ t̪ ɑ v ɔ k
головних	ɦ ɔ l̪ ɔ v n̪ ɪ x
торговельних	t̪ ɔ r ɦ ɔ v ɛ lʲ n̪ ɪ x
методи	m ɛ t̪ ɔ d̪ ɪ
патріарха	p ɑ t̪ rʲ i ɑ r x ɑ
Кирила	k ɪ r ɪ l̪ ɑ
завершений	z̪ ɑ v ɛ r ʃ ɛ n̪ ɪ j
аналіз	ɑ n̪ ɑ lʲ i z̪
загрозу	z̪ ɑ ɦ r ɔ z̪ u
обмежень	ɔ b m ɛ ʒ ɛ n̪ʲ
спілкуватися	s̪ p i l̪ k u v ɑ t̪ ɪ s̪ ɑ
директор	d̪ ɪ r ɛ k t̪ ɔ r
назустріч	n̪ ɑ z̪ u s̪ t̪ rʲ i t̪ ʃ
баланс	b ɑ l̪ ɑ n̪ s̪
згідно	z̪ ɦ i d̪ n̪ ɔ
торгів	t̪ ɔ r ɦ i v
індекси	i n̪ d̪ ɛ k s̪ ɪ
продемонстрували	p r ɔ d̪ ɛ m ɔ n̪ s̪ t̪ r u v ɑ l̪ ɪ
організатори	ɔ r ɦ ɑ n̪ʲ i z̪ ɑ t̪ ɔ r ɪ
партія	p ɑ r t̪ i ɑ
частково	t̪ ʃ ɑ s̪ t̪ k ɔ v ɔ
підтвердили	p i d̪ t̪ v ɛ r d̪ ɪ l̪ ɪ
КМДА	k m d̪ ɑ
Руслан	r u s̪ l̪ ɑ n̪
Крамаренко	k r ɑ m ɑ r ɛ n̪ k ɔ
сказано	s̪ k ɑ z̪ ɑ n̪ ɔ
стандартів	s̪ t̪ ɑ n̪ d̪ ɑ r t̪ i v
точніше	t̪ ɔ t̪ ʃ n̪ʲ i ʃ ɛ
економіка	ɛ k ɔ n̪ ɔ m i k ɑ
напрямок	n̪ ɑ p rʲ ɑ m ɔ k
баба	b ɑ b ɑ
Палажка	p ɑ l̪ ɑ ʒ k ɑ
вдарила	v d̪ ɑ r ɪ l̪ ɑ
стільцем	s̪ t̪ i lʲ t̪s̪ ɛ m
поклони	p ɔ k l̪ ɔ n̪ ɪ
Холодний	x ɔ l̪ ɔ d̪ n̪ ɪ j
готуються	ɦ ɔ t̪ u u t̪ s̪ ɑ
Ігор	i ɦ ɔ r
боці	b ɔ t̪s̪ʲ i
кажучи	k ɑ ʒ u t̪ ʃ ɪ
явно	j ɑ v n̪ ɔ
наче	n̪ ɑ t̪ ʃ ɛ
порядки	p ɔ rʲ ɑ d̪ k ɪ
розвиватися	r ɔ z̪ v ɪ v ɑ t̪ ɪ s̪ ɑ
версія	v ɛ r s̪ i ɑ
входять	v x ɔ d̪ʲ ɑ t̪
ФДМ	f d̪ m
Рябченко	rʲ ɑ b t̪ ʃ ɛ n̪ k ɔ
Олександру	ɔ l̪ ɛ k s̪ ɑ n̪ d̪ r u
пострадянському	p ɔ s̪ t̪ r ɑ d̪ʲ ɑ n̪ s̪ k ɔ m u
просторі	p r ɔ s̪ t̪ ɔ rʲ i
розгляду	r ɔ z̪ ɦ lʲ ɑ d̪ u
вирішено	v ɪ rʲ i ʃ ɛ n̪ ɔ
попередніми	p ɔ p ɛ r ɛ d̪ n̪ʲ i m ɪ
силами	s̪ ɪ l̪ ɑ m ɪ
зосталося	z̪ ɔ s̪ t̪ ɑ l̪ ɔ s̪ ɑ
зостався	z̪ ɔ s̪ t̪ ɑ v s̪ ɑ
державою	d̪ ɛ r ʒ ɑ v ɔ u
йди	j d̪ ɪ
державу	d̪ ɛ r ʒ ɑ v u
останніх	ɔ s̪ t̪ ɑ n̪ n̪ʲ i x
відновлення	v i d̪ n̪ ɔ v l̪ ɛ n̪ n̪ʲ ɑ
поліції	p ɔ lʲ i t̪s̪ʲ i j i
діжду	d̪ʲ i ʒ d̪ u
заробітки	z̪ ɑ r ɔ b i t̪ k ɪ
твоїх	t̪ v ɔ j i x
небагато	n̪ ɛ b ɑ ɦ ɑ t̪ ɔ
діла	d̪ʲ i l̪ ɑ
вимогою	v ɪ m ɔ ɦ ɔ u
звільнити	z̪ v i lʲ n̪ ɪ t̪ ɪ
підлітків	p i d̪ lʲ i t̪ k i v
розвивати	r ɔ z̪ v ɪ v ɑ t̪ ɪ
місцях	m i s̪ t̪s̪ʲ ɑ x
наявності	n̪ ɑ ɑ v n̪ ɔ s̪ t̪ i
матчі	m ɑ t̪ t̪ ʃ i
Окунева	ɔ k u n̪ ɛ v ɑ
бюджетних	b u d̪ ʒ ɛ t̪ n̪ ɪ x
Єфремов	j ɛ f r ɛ m ɔ v
міняти	m i n̪ʲ ɑ t̪ ɪ
Колеснік	k ɔ l̪ ɛ s̪ n̪ʲ i k
жінок	ʒ i n̪ ɔ k
лікарем	lʲ i k ɑ r ɛ m
усвідомити	u s̪ v i d̪ ɔ m ɪ t̪ ɪ
терміну	t̪ ɛ r m i n̪ u
націоналізм	n̪ ɑ t̪s̪ʲ i ɔ n̪ ɑ lʲ i z̪ m
курс	k u r s̪
незалежність	n̪ ɛ z̪ ɑ l̪ ɛ ʒ n̪ʲ i s̪ t̪
Незалежності	n̪ ɛ z̪ ɑ l̪ ɛ ʒ n̪ ɔ s̪ t̪ i
національне	n̪ ɑ t̪s̪ʲ i ɔ n̪ ɑ lʲ n̪ ɛ
свято	s̪ v ɑ t̪ ɔ
повний	p ɔ v n̪ ɪ j
збитків	z̪ b ɪ t̪ k i v
автомобілів	ɑ v t̪ ɔ m ɔ b i lʲ i v
швидкої	ʃ v ɪ d̪ k ɔ j i
залишаються	z̪ ɑ l̪ ɪ ʃ ɑ u t̪ s̪ ɑ
урожай	u r ɔ ʒ ɑ j
знайду	z̪ n̪ ɑ j d̪ u
переведу	p ɛ r ɛ v ɛ d̪ u
навчального	n̪ ɑ v t̪ ʃ ɑ lʲ n̪ ɔ ɦ ɔ
Чіпку	t̪ ʃ i p k u
пройняв	p r ɔ j n̪ʲ ɑ v
наскрізь	n̪ ɑ s̪ k rʲ i z̪ʲ
навчатися	n̪ ɑ v t̪ ʃ ɑ t̪ ɪ s̪ ɑ
необхідних	n̪ ɛ ɔ b x i d̪ n̪ ɪ x
рішень	rʲ i ʃ ɛ n̪ʲ
вип'єте	v ɪ p j ɛ t̪ ɛ
холодного	x ɔ l̪ ɔ d̪ n̪ ɔ ɦ ɔ
шансів	ʃ ɑ n̪ s̪ i v
вступити	v s̪ t̪ u p ɪ t̪ ɪ
фільмів	f i lʲ m i v
зверніть	z̪ v ɛ r n̪ʲ i t̪
статтю	s̪ t̪ ɑ t̪ t̪ u
Інститут	i n̪ s̪ t̪ ɪ t̪ u t̪
стратегічних	s̪ t̪ r ɑ t̪ ɛ ɦ i t̪ ʃ n̪ ɪ x
технічних	t̪ ɛ x n̪ʲ i t̪ ʃ n̪ ɪ x
налию	n̪ ɑ l̪ ɪ u
наглядаєш	n̪ ɑ ɦ lʲ ɑ d̪ ɑ ɛ ʃ
землею	z̪ ɛ m l̪ ɛ u
маєш	m ɑ ɛ ʃ
волю	v ɔ lʲ u
суми	s̪ u m ɪ
звернулися	z̪ v ɛ r n̪ u l̪ ɪ s̪ ɑ
Інтернеті	i n̪ t̪ ɛ r n̪ ɛ t̪ i
з'явилася	z̪ j ɑ v ɪ l̪ ɑ s̪ ɑ
зірка	z̪ʲ i r k ɑ
заявою	z̪ ɑ ɑ v ɔ u
намагався	n̪ ɑ m ɑ ɦ ɑ v s̪ ɑ
буквально	b u k v ɑ lʲ n̪ ɔ
кланяючись	k l̪ ɑ n̪ʲ ɑ u t̪ ʃ ɪ s̪
Остап	ɔ s̪ t̪ ɑ p
американських	ɑ m ɛ r ɪ k ɑ n̪ s̪ k ɪ x
трапляються	t̪ r ɑ p lʲ ɑ u t̪ s̪ ɑ
цікаві	t̪s̪ʲ i k ɑ v i
стали	s̪ t̪ ɑ l̪ ɪ
комісія	k ɔ m i s̪ i ɑ
кожній	k ɔ ʒ n̪ʲ i j
найближчих	n̪ ɑ j b l̪ ɪ ʒ t̪ ʃ ɪ x
парламентських	p ɑ r l̪ ɑ m ɛ n̪ t̪ s̪ k ɪ x
запитань	z̪ ɑ p ɪ t̪ ɑ n̪ʲ
актуальні	ɑ k t̪ u ɑ lʲ n̪ʲ i
втрати	v t̪ r ɑ t̪ ɪ
дивно	d̪ ɪ v n̪ ɔ
Миколи	m ɪ k ɔ l̪ ɪ
Костьовича	k ɔ s̪ t̪ ɔ v ɪ t̪ ʃ ɑ
лаві	l̪ ɑ v i
скорчилась	s̪ k ɔ r t̪ ʃ ɪ l̪ ɑ s̪
погибелі	p ɔ ɦ ɪ b ɛ lʲ i
Київській	k ɪ j i v s̪ k i j
дефолт	d̪ ɛ f ɔ l̪ t̪
вікно	v i k n̪ ɔ
Європу	j ɛ v r ɔ p u
винятком	v ɪ n̪ʲ ɑ t̪ k ɔ m
АПК	ɑ p k
боргу	b ɔ r ɦ u
прихильників	p r ɪ x ɪ lʲ n̪ ɪ k i v
сімнадцята	s̪ i m n̪ ɑ d̪ t̪s̪ʲ ɑ t̪ ɑ
сет	s̪ ɛ t̪
Кремль	k r ɛ m lʲ
Седнєв	s̪ ɛ d̪ n̪ʲ ɛ v
бере	b ɛ r ɛ
переслідування	p ɛ r ɛ s̪ lʲ i d̪ u v ɑ n̪ n̪ʲ ɑ
неділі	n̪ ɛ d̪ʲ i lʲ i
десятій	d̪ ɛ s̪ ɑ t̪ i j
ранку	r ɑ n̪ k u
п'ятому	p j ɑ t̪ ɔ m u
каналі	k ɑ n̪ ɑ lʲ i
сільські	s̪ i lʲ s̪ k i
комітет	k ɔ m i t̪ ɛ t̪
офіційні	ɔ f i t̪s̪ʲ i j n̪ʲ i
транш	t̪ r ɑ n̪ ʃ
виконання	v ɪ k ɔ n̪ ɑ n̪ n̪ʲ ɑ
вночі	v n̪ ɔ t̪ ʃ i
адресу	ɑ d̪ r ɛ s̪ u
пропонують	p r ɔ p ɔ n̪ u u t̪
фільми	f i lʲ m ɪ
відповідати	v i d̪ p ɔ v i d̪ ɑ t̪ ɪ
віддали	v i d̪ d̪ ɑ l̪ ɪ
Нашої	n̪ ɑ ʃ ɔ j i
зібрав	z̪ʲ i b r ɑ v
Богдан	b ɔ ɦ d̪ ɑ n̪
плечі	p l̪ ɛ t̪ ʃ i
Валентин	v ɑ l̪ ɛ n̪ t̪ ɪ n̪
Іванович	i v ɑ n̪ ɔ v ɪ t̪ ʃ
особисті	ɔ s̪ ɔ b ɪ s̪ t̪ i
контакти	k ɔ n̪ t̪ ɑ k t̪ ɪ
кивнув	k ɪ v n̪ u v
сердито	s̪ ɛ r d̪ ɪ t̪ ɔ
дивіться	d̪ ɪ v i t̪ s̪ ɑ
щопонеділка	ʃ t̪ ʃ ɔ p ɔ n̪ ɛ d̪ʲ i l̪ k ɑ
двадцятій	d̪ v ɑ d̪ t̪s̪ʲ ɑ t̪ i j
природа	p r ɪ r ɔ d̪ ɑ
чоловіче	t̪ ʃ ɔ l̪ ɔ v i t̪ ʃ ɛ
питаєш	p ɪ t̪ ɑ ɛ ʃ
ціле	t̪s̪ʲ i l̪ ɛ
необмазана	n̪ ɛ ɔ b m ɑ z̪ ɑ n̪ ɑ
невкрита	n̪ ɛ v k r ɪ t̪ ɑ
обгороджений	ɔ b ɦ ɔ r ɔ d̪ ʒ ɛ n̪ ɪ j
угода	u ɦ ɔ d̪ ɑ
тисяча	t̪ ɪ s̪ ɑ t̪ ʃ ɑ
вісімсот	v i s̪ i m s̪ ɔ t̪
шістдесят	ʃ i s̪ t̪ d̪ ɛ s̪ ɑ t̪
податкового	p ɔ d̪ ɑ t̪ k ɔ v ɔ ɦ ɔ
керівників	k ɛ rʲ i v n̪ ɪ k i v
німецька	n̪ʲ i m ɛ t̪s̪ʲ k ɑ
робочих	r ɔ b ɔ t̪ ʃ ɪ x
якась	j ɑ k ɑ s̪
масово	m ɑ s̪ ɔ v ɔ
стихають	s̪ t̪ ɪ x ɑ u t̪
негоди	n̪ ɛ ɦ ɔ d̪ ɪ
Шевченка	ʃ ɛ v t̪ ʃ ɛ n̪ k ɑ
удвічі	u d̪ v i t̪ ʃ i
податків	p ɔ d̪ ɑ t̪ k i v
Леоніда	l̪ ɛ ɔ n̪ʲ i d̪ ɑ
пропадає	p r ɔ p ɑ d̪ ɑ ɛ
тікати	t̪ i k ɑ t̪ ɪ
мерщій	m ɛ r ʃ t̪ ʃ i j
лихо	l̪ ɪ x ɔ
забрав	z̪ ɑ b r ɑ v
переживає	p ɛ r ɛ ʒ ɪ v ɑ ɛ
сучасної	s̪ u t̪ ʃ ɑ s̪ n̪ ɔ j i
уся	u s̪ ɑ
врода	v r ɔ d̪ ɑ
Тернопільської	t̪ ɛ r n̪ ɔ p i lʲ s̪ k ɔ j i
класі	k l̪ ɑ s̪ i
межах	m ɛ ʒ ɑ x
рідної	rʲ i d̪ n̪ ɔ j i
фракції	f r ɑ k t̪s̪ʲ i j i
діями	d̪ʲ i ɑ m ɪ
підготував	p i d̪ ɦ ɔ t̪ u v ɑ v
одіозний	ɔ d̪ʲ i ɔ z̪ n̪ ɪ j
правлячій	p r ɑ v lʲ ɑ t̪ ʃ i j
політичній	p ɔ lʲ i t̪ ɪ t̪ ʃ n̪ʲ i j
силі	s̪ ɪ lʲ i
незалежно	n̪ ɛ z̪ ɑ l̪ ɛ ʒ n̪ ɔ
інформацією	i n̪ f ɔ r m ɑ t̪s̪ʲ i ɛ u
уперше	u p ɛ r ʃ ɛ
виник	v ɪ n̪ ɪ k
столичної	s̪ t̪ ɔ l̪ ɪ t̪ ʃ n̪ ɔ j i
фірми	f i r m ɪ
художників	x u d̪ ɔ ʒ n̪ ɪ k i v
фото	f ɔ t̪ ɔ
офіційного	ɔ f i t̪s̪ʲ i j n̪ ɔ ɦ ɔ
підтвердження	p i d̪ t̪ v ɛ r d̪ ʒ ɛ n̪ n̪ʲ ɑ
документа	d̪ ɔ k u m ɛ n̪ t̪ ɑ
освіту	ɔ s̪ v i t̪ u
обіцяли	ɔ b i t̪s̪ʲ ɑ l̪ ɪ
ряд	rʲ ɑ d̪
зникли	z̪ n̪ ɪ k l̪ ɪ
праці	p r ɑ t̪s̪ʲ i
ефективності	ɛ f ɛ k t̪ ɪ v n̪ ɔ s̪ t̪ i
подібна	p ɔ d̪ʲ i b n̪ ɑ
Голодомор	ɦ ɔ l̪ ɔ d̪ ɔ m ɔ r
астрономи	ɑ s̪ t̪ r ɔ n̪ ɔ m ɪ
наукового	n̪ ɑ u k ɔ v ɔ ɦ ɔ
підходу	p i d̪ x ɔ d̪ u
тренером	t̪ r ɛ n̪ ɛ r ɔ m
інтерв	i n̪ t̪ ɛ r v
ю	j u
газеті	ɦ ɑ z̪ ɛ t̪ i
розпаду	r ɔ z̪ p ɑ d̪ u
Мельниченка	m ɛ lʲ n̪ ɪ t̪ ʃ ɛ n̪ k ɑ
призначено	p r ɪ z̪ n̪ ɑ t̪ ʃ ɛ n̪ ɔ
заробітчани	z̪ ɑ r ɔ b i t̪ t̪ ʃ ɑ n̪ ɪ
Лівії	lʲ i v i j i
секунд	s̪ ɛ k u n̪ d̪
завершилася	z̪ ɑ v ɛ r ʃ ɪ l̪ ɑ s̪ ɑ
дома	d̪ ɔ m ɑ
Москві	m ɔ s̪ k v i
доля	d̪ ɔ lʲ ɑ
винятково	v ɪ n̪ʲ ɑ t̪ k ɔ v ɔ
правовому	p r ɑ v ɔ v ɔ m u
полі	p ɔ lʲ i
приватні	p r ɪ v ɑ t̪ n̪ʲ i
Пороха	p ɔ r ɔ x ɑ
цією	t̪s̪ʲ i ɛ u
справою	s̪ p r ɑ v ɔ u
ціною	t̪s̪ʲ i n̪ ɔ u
казати	k ɑ z̪ ɑ t̪ ɪ
переговори	p ɛ r ɛ ɦ ɔ v ɔ r ɪ
люблять	lʲ u b lʲ ɑ t̪
служби	s̪ l̪ u ʒ b ɪ
запросив	z̪ ɑ p r ɔ s̪ ɪ v
Кабінету	k ɑ b i n̪ ɛ t̪ u
Міністрів	m i n̪ʲ i s̪ t̪ rʲ i v
хотіла	x ɔ t̪ i l̪ ɑ
проводити	p r ɔ v ɔ d̪ ɪ t̪ ɪ
пенсійну	p ɛ n̪ s̪ i j n̪ u
виграв	v ɪ ɦ r ɑ v
зміна	z̪ m i n̪ ɑ
політичного	p ɔ lʲ i t̪ ɪ t̪ ʃ n̪ ɔ ɦ ɔ
побачу	p ɔ b ɑ t̪ ʃ u
чайку	t̪ ʃ ɑ j k u
польоті	p ɔ lʲ ɔ t̪ i
болоті	b ɔ l̪ ɔ t̪ i
працювала	p r ɑ t̪s̪ʲ u v ɑ l̪ ɑ
Сирії	s̪ ɪ rʲ i j i
інтелектуалів	i n̪ t̪ ɛ l̪ ɛ k t̪ u ɑ lʲ i v
порозуміння	p ɔ r ɔ z̪ u m i n̪ n̪ʲ ɑ
пальців	p ɑ lʲ t̪s̪ʲ i v
прихильники	p r ɪ x ɪ lʲ n̪ ɪ k ɪ
площі	p l̪ ɔ ʃ t̪ ʃ i
Леніна	l̪ ɛ n̪ʲ i n̪ ɑ
квартирі	k v ɑ r t̪ ɪ rʲ i
старих	s̪ t̪ ɑ r ɪ x
тенісу	t̪ ɛ n̪ʲ i s̪ u
врізався	v rʲ i z̪ ɑ v s̪ ɑ
автобус	ɑ v t̪ ɔ b u s̪
Масса	m ɑ s̪ s̪ ɑ
Алонсо	ɑ l̪ ɔ n̪ s̪ ɔ
прем'єр	p r ɛ m j ɛ r
Тігіпко	t̪ i ɦ i p k ɔ
несподівано	n̪ ɛ s̪ p ɔ d̪ʲ i v ɑ n̪ ɔ
речей	r ɛ t̪ ʃ ɛ j
виборців	v ɪ b ɔ r t̪s̪ʲ i v
медики	m ɛ d̪ ɪ k ɪ
опинився	ɔ p ɪ n̪ ɪ v s̪ ɑ
вигравати	v ɪ ɦ r ɑ v ɑ t̪ ɪ
матчах	m ɑ t̪ t̪ ʃ ɑ x
комплексів	k ɔ m p l̪ ɛ k s̪ i v
стосунки	s̪ t̪ ɔ s̪ u n̪ k ɪ
знадобитися	z̪ n̪ ɑ d̪ ɔ b ɪ t̪ ɪ s̪ ɑ
прийняття	p r ɪ j n̪ʲ ɑ t̪ t̪ ɑ
масових	m ɑ s̪ ɔ v ɪ x
церкві	t̪s̪ ɛ r k v i
держбюджету	d̪ ɛ r ʒ b u d̪ ʒ ɛ t̪ u
спрямовані	s̪ p rʲ ɑ m ɔ v ɑ n̪ʲ i
гарантії	ɦ ɑ r ɑ n̪ t̪ i j i
Адміністрації	ɑ d̪ m i n̪ʲ i s̪ t̪ r ɑ t̪s̪ʲ i j i
пояснення	p ɔ ɑ s̪ n̪ ɛ n̪ n̪ʲ ɑ
Івано–Франківську	i v ɑ n̪ ɔ f r ɑ n̪ k i v s̪ k u
п'яти	p j ɑ t̪ ɪ
збільшувати	z̪ b i lʲ ʃ u v ɑ t̪ ɪ
нафти	n̪ ɑ f t̪ ɪ
очевидно	ɔ t̪ ʃ ɛ v ɪ d̪ n̪ ɔ
територія	t̪ ɛ r ɪ t̪ ɔ rʲ i ɑ
Київської	k ɪ j i v s̪ k ɔ j i
відправили	v i d̪ p r ɑ v ɪ l̪ ɪ
обрав	ɔ b r ɑ v
формат	f ɔ r m ɑ t̪
чудовий	t̪ ʃ u d̪ ɔ v ɪ j
наступ	n̪ ɑ s̪ t̪ u p
підписано	p i d̪ p ɪ s̪ ɑ n̪ ɔ
переговорів	p ɛ r ɛ ɦ ɔ v ɔ rʲ i v
зіграв	z̪ʲ i ɦ r ɑ v
внічию	v n̪ʲ i t̪ ʃ ɪ u
побіг	p ɔ b i ɦ
волость	v ɔ l̪ ɔ s̪ t̪
впав	v p ɑ v
ключових	k lʲ u t̪ ʃ ɔ v ɪ x
виробляти	v ɪ r ɔ b lʲ ɑ t̪ ɪ
контракт	k ɔ n̪ t̪ r ɑ k t̪
клубом	k l̪ u b ɔ m
кінці	k i n̪ t̪s̪ʲ i
добу	d̪ ɔ b u
механізмів	m ɛ x ɑ n̪ʲ i z̪ m i v
глобалізації	ɦ l̪ ɔ b ɑ lʲ i z̪ ɑ t̪s̪ʲ i j i
купив	k u p ɪ v
гарне	ɦ ɑ r n̪ ɛ
намисто	n̪ ɑ m ɪ s̪ t̪ ɔ
бачишь	b ɑ t̪ ʃ ɪ ʃʲ
програє	p r ɔ ɦ r ɑ ɛ
рахунком	r ɑ x u n̪ k ɔ m
сімнадцять	s̪ i m n̪ ɑ d̪ t̪s̪ʲ ɑ t̪
нуль	n̪ u lʲ
Укрексімбанк	u k r ɛ k s̪ i m b ɑ n̪ k
Ощадбанк	ɔ ʃ t̪ ʃ ɑ d̪ b ɑ n̪ k
брифінгу	b r ɪ f i n̪ ɦ u
малих	m ɑ l̪ ɪ x
шинок	ʃ ɪ n̪ ɔ k
чемпіоном	t̪ ʃ ɛ m p i ɔ n̪ ɔ m
спробував	s̪ p r ɔ b u v ɑ v
банки	b ɑ n̪ k ɪ
процесі	p r ɔ t̪s̪ ɛ s̪ i
наприклад	n̪ ɑ p r ɪ k l̪ ɑ d̪
процесів	p r ɔ t̪s̪ ɛ s̪ i v
концерт	k ɔ n̪ t̪s̪ ɛ r t̪
відвідувачів	v i d̪ v i d̪ u v ɑ t̪ ʃ i v
УПА	u p ɑ
народним	n̪ ɑ r ɔ d̪ n̪ ɪ m
депутатом	d̪ ɛ p u t̪ ɑ t̪ ɔ m
дружину	d̪ r u ʒ ɪ n̪ u
мерії	m ɛ rʲ i j i
рукою	r u k ɔ u
кроком	k r ɔ k ɔ m
організаторів	ɔ r ɦ ɑ n̪ʲ i z̪ ɑ t̪ ɔ rʲ i v
порушень	p ɔ r u ʃ ɛ n̪ʲ
філармонії	f i l̪ ɑ r m ɔ n̪ʲ i j i
справжнє	s̪ p r ɑ v ʒ n̪ʲ ɛ
Червоної	t̪ ʃ ɛ r v ɔ n̪ ɔ j i
громадянської	ɦ r ɔ m ɑ d̪ʲ ɑ n̪ s̪ k ɔ j i
надія	n̪ ɑ d̪ʲ i ɑ
обгортає	ɔ b ɦ ɔ r t̪ ɑ ɛ
добрими	d̪ ɔ b r ɪ m ɪ
думками	d̪ u m k ɑ m ɪ
бажаннями	b ɑ ʒ ɑ n̪ n̪ʲ ɑ m ɪ
неабияке	n̪ ɛ ɑ b ɪ ɑ k ɛ
пенсіонерів	p ɛ n̪ s̪ i ɔ n̪ ɛ rʲ i v
державних	d̪ ɛ r ʒ ɑ v n̪ ɪ x
інституцій	i n̪ s̪ t̪ ɪ t̪ u t̪s̪ʲ i j
переважно	p ɛ r ɛ v ɑ ʒ n̪ ɔ
бачте	b ɑ t̪ ʃ t̪ ɛ
сидітиме	s̪ ɪ d̪ʲ i t̪ ɪ m ɛ
сумна	s̪ u m n̪ ɑ
подорожчання	p ɔ d̪ ɔ r ɔ ʒ t̪ ʃ ɑ n̪ n̪ʲ ɑ
банк	b ɑ n̪ k
здійснювати	z̪ d̪ʲ i j s̪ n̪ʲ u v ɑ t̪ ɪ
валютні	v ɑ lʲ u t̪ n̪ʲ i
народився	n̪ ɑ r ɔ d̪ ɪ v s̪ ɑ
дев'ятсот	d̪ ɛ v j ɑ t̪ s̪ ɔ t̪
вісімдесят	v i s̪ i m d̪ ɛ s̪ ɑ t̪
сьомого	s̪ ɔ m ɔ ɦ ɔ
знала	z̪ n̪ ɑ l̪ ɑ
головною	ɦ ɔ l̪ ɔ v n̪ ɔ u
брак	b r ɑ k
шосту	ʃ ɔ s̪ t̪ u
родом	r ɔ d̪ ɔ m
друку	d̪ r u k u
добрих	d̪ ɔ b r ɪ x
випадково	v ɪ p ɑ d̪ k ɔ v ɔ
фальсифікації	f ɑ lʲ s̪ ɪ f i k ɑ t̪s̪ʲ i j i
Житомирської	ʒ ɪ t̪ ɔ m ɪ r s̪ k ɔ j i
Кабмін	k ɑ b m i n̪
доручення	d̪ ɔ r u t̪ ʃ ɛ n̪ n̪ʲ ɑ
трава	t̪ r ɑ v ɑ
Євгеном	j ɛ v ɦ ɛ n̪ ɔ m
Кісильовим	k i s̪ ɪ lʲ ɔ v ɪ m
показує	p ɔ k ɑ z̪ u ɛ
Інтер	i n̪ t̪ ɛ r
п'ятниці	p j ɑ t̪ n̪ ɪ t̪s̪ʲ i
годині	ɦ ɔ d̪ ɪ n̪ʲ i
кола	k ɔ l̪ ɑ
програмі	p r ɔ ɦ r ɑ m i
задоволений	z̪ ɑ d̪ ɔ v ɔ l̪ ɛ n̪ ɪ j
результатом	r ɛ z̪ u lʲ t̪ ɑ t̪ ɔ m
шістнадцяте	ʃ i s̪ t̪ n̪ ɑ d̪ t̪s̪ʲ ɑ t̪ ɛ
четверта	t̪ ʃ ɛ t̪ v ɛ r t̪ ɑ
представлені	p r ɛ d̪ s̪ t̪ ɑ v l̪ ɛ n̪ʲ i
картин	k ɑ r t̪ ɪ n̪
Ван	v ɑ n̪
Гога	ɦ ɔ ɦ ɑ
маленьких	m ɑ l̪ ɛ n̪ʲ k ɪ x
продовжити	p r ɔ d̪ ɔ v ʒ ɪ t̪ ɪ
Манчестер	m ɑ n̪ t̪ ʃ ɛ s̪ t̪ ɛ r
Юнайтед	j u n̪ ɑ j t̪ ɛ d̪
будівлі	b u d̪ʲ i v lʲ i
моменти	m ɔ m ɛ n̪ t̪ ɪ
розширення	r ɔ z̪ ʃ ɪ r ɛ n̪ n̪ʲ ɑ
видатків	v ɪ d̪ ɑ t̪ k i v
Батьківщина	b ɑ t̪ k i v ʃ t̪ ʃ ɪ n̪ ɑ
прокурор	p r ɔ k u r ɔ r
півріччя	p i v rʲ i t̪ ʃ t̪ ʃ ɑ
учасниками	u t̪ ʃ ɑ s̪ n̪ ɪ k ɑ m ɪ
охорони	ɔ x ɔ r ɔ n̪ ɪ
навколишнього	n̪ ɑ v k ɔ l̪ ɪ ʃ n̪ʲ ɔ ɦ ɔ
вуха	v u x ɑ
почує	p ɔ t̪ ʃ u ɛ
діалогу	d̪ʲ i ɑ l̪ ɔ ɦ u
найбільш	n̪ ɑ j b i lʲ ʃ
пройде	p r ɔ j d̪ ɛ
помаранчевої	p ɔ m ɑ r ɑ n̪ t̪ ʃ ɛ v ɔ j i
використання	v ɪ k ɔ r ɪ s̪ t̪ ɑ n̪ n̪ʲ ɑ
регіональної	r ɛ ɦ i ɔ n̪ ɑ lʲ n̪ ɔ j i
центр	t̪s̪ ɛ n̪ t̪ r
очикують	ɔ t̪ ʃ ɪ k u u t̪
гравці	ɦ r ɑ v t̪s̪ʲ i
виступати	v ɪ s̪ t̪ u p ɑ t̪ ɪ
збірну	z̪ b i r n̪ u
проходять	p r ɔ x ɔ d̪ʲ ɑ t̪
півзахисника	p i v z̪ ɑ x ɪ s̪ n̪ ɪ k ɑ
Укртатнафта	u k r t̪ ɑ t̪ n̪ ɑ f t̪ ɑ
терміново	t̪ ɛ r m i n̪ ɔ v ɔ
розпочати	r ɔ z̪ p ɔ t̪ ʃ ɑ t̪ ɪ
виробництва	v ɪ r ɔ b n̪ ɪ t̪s̪ t̪ v ɑ
надані	n̪ ɑ d̪ ɑ n̪ʲ i
відвідин	v i d̪ v i d̪ ɪ n̪
щоразу	ʃ t̪ ʃ ɔ r ɑ z̪ u
квіти	k v i t̪ ɪ
визнали	v ɪ z̪ n̪ ɑ l̪ ɪ
винним	v ɪ n̪ n̪ ɪ m
вбивстві	v b ɪ v s̪ t̪ v i
словах	s̪ l̪ ɔ v ɑ x
місія	m i s̪ i ɑ
проголосував	p r ɔ ɦ ɔ l̪ ɔ s̪ u v ɑ v
депутат	d̪ ɛ p u t̪ ɑ t̪
затримані	z̪ ɑ t̪ r ɪ m ɑ n̪ʲ i
фінальному	f i n̪ ɑ lʲ n̪ ɔ m u
Мазепи	m ɑ z̪ ɛ p ɪ
остання	ɔ s̪ t̪ ɑ n̪ n̪ʲ ɑ
старшого	s̪ t̪ ɑ r ʃ ɔ ɦ ɔ
тліє	t̪ lʲ i ɛ
безневинних	b ɛ z̪ n̪ ɛ v ɪ n̪ n̪ ɪ x
вочевидь	v ɔ t̪ ʃ ɛ v ɪ d̪ʲ
пенсії	p ɛ n̪ s̪ i j i
Миколі	m ɪ k ɔ lʲ i
регіоні	r ɛ ɦ i ɔ n̪ʲ i
Незважаючи	n̪ ɛ z̪ v ɑ ʒ ɑ u t̪ ʃ ɪ
прогнозують	p r ɔ ɦ n̪ ɔ z̪ u u t̪
фінансових	f i n̪ ɑ n̪ s̪ ɔ v ɪ x
оцінили	ɔ t̪s̪ʲ i n̪ ɪ l̪ ɪ
польський	p ɔ lʲ s̪ k ɪ j
виборчої	v ɪ b ɔ r t̪ ʃ ɔ j i
вода	v ɔ d̪ ɑ
компенсувати	k ɔ m p ɛ n̪ s̪ u v ɑ t̪ ɪ
американський	ɑ m ɛ r ɪ k ɑ n̪ s̪ k ɪ j
солдат	s̪ ɔ l̪ d̪ ɑ t̪
Іраку	i r ɑ k u
кримінальної	k r ɪ m i n̪ ɑ lʲ n̪ ɔ j i
надійшло	n̪ ɑ d̪ʲ i j ʃ l̪ ɔ
кімнати	k i m n̪ ɑ t̪ ɪ
сидять	s̪ ɪ d̪ʲ ɑ t̪
пройшло	p r ɔ j ʃ l̪ ɔ
Богдана	b ɔ ɦ d̪ ɑ n̪ ɑ
гетьмана	ɦ ɛ t̪ m ɑ n̪ ɑ
читачі	t̪ ʃ ɪ t̪ ɑ t̪ ʃ i
автори	ɑ v t̪ ɔ r ɪ
герої	ɦ ɛ r ɔ j i
Партії	p ɑ r t̪ i j i
призвело	p r ɪ z̪ v ɛ l̪ ɔ
падіння	p ɑ d̪ʲ i n̪ n̪ʲ ɑ
підручники	p i d̪ r u t̪ ʃ n̪ ɪ k ɪ
Портнова	p ɔ r t̪ n̪ ɔ v ɑ
виділить	v ɪ d̪ʲ i l̪ ɪ t̪
називають	n̪ ɑ z̪ ɪ v ɑ u t̪
десятків	d̪ ɛ s̪ ɑ t̪ k i v
помилками	p ɔ m ɪ l̪ k ɑ m ɪ
доби	d̪ ɔ b ɪ
нечистого	n̪ ɛ t̪ ʃ ɪ s̪ t̪ ɔ ɦ ɔ
городу	ɦ ɔ r ɔ d̪ u
влізла	v lʲ i z̪ l̪ ɑ
старенька	s̪ t̪ ɑ r ɛ n̪ʲ k ɑ
маленький	m ɑ l̪ ɛ n̪ʲ k ɪ j
внутрішній	v n̪ u t̪ rʲ i ʃ n̪ʲ i j
зобов'язання	z̪ ɔ b ɔ v j ɑ z̪ ɑ n̪ n̪ʲ ɑ
бензин	b ɛ n̪ z̪ ɪ n̪
почати	p ɔ t̪ ʃ ɑ t̪ ɪ
ректора	r ɛ k t̪ ɔ r ɑ
котра	k ɔ t̪ r ɑ
громадянам	ɦ r ɔ m ɑ d̪ʲ ɑ n̪ ɑ m
мусимо	m u s̪ ɪ m ɔ
Дмитренко	d̪ m ɪ t̪ r ɛ n̪ k ɔ
скинув	s̪ k ɪ n̪ u v
Галю	ɦ ɑ lʲ u
Комітет	k ɔ m i t̪ ɛ t̪
рублів	r u b lʲ i v
долар	d̪ ɔ l̪ ɑ r
місяця	m i s̪ ɑ t̪s̪ʲ ɑ
портал	p ɔ r t̪ ɑ l̪
інституції	i n̪ s̪ t̪ ɪ t̪ u t̪s̪ʲ i j i
серйозно	s̪ ɛ r j ɔ z̪ n̪ ɔ
дискусії	d̪ ɪ s̪ k u s̪ i j i
дійшовши	d̪ʲ i j ʃ ɔ v ʃ ɪ
сприйняття	s̪ p r ɪ j n̪ʲ ɑ t̪ t̪ ɑ
злочинів	z̪ l̪ ɔ t̪ ʃ ɪ n̪ʲ i v
комунізму	k ɔ m u n̪ʲ i z̪ m u
звіт	z̪ v i t̪
враховувати	v r ɑ x ɔ v u v ɑ t̪ ɪ
областей	ɔ b l̪ ɑ s̪ t̪ ɛ j
реформування	r ɛ f ɔ r m u v ɑ n̪ n̪ʲ ɑ
наслідок	n̪ ɑ s̪ lʲ i d̪ ɔ k
жодна	ʒ ɔ d̪ n̪ ɑ
соромно	s̪ ɔ r ɔ m n̪ ɔ
зупинитися	z̪ u p ɪ n̪ ɪ t̪ ɪ s̪ ɑ
вчасно	v t̪ ʃ ɑ s̪ n̪ ɔ
ясно	j ɑ s̪ n̪ ɔ
слідчих	s̪ lʲ i d̪ t̪ ʃ ɪ x
звернувся	z̪ v ɛ r n̪ u v s̪ ɑ
російській	r ɔ s̪ i j s̪ k i j
мові	m ɔ v i
усього	u s̪ ɔ ɦ ɔ
можете	m ɔ ʒ ɛ t̪ ɛ
провокації	p r ɔ v ɔ k ɑ t̪s̪ʲ i j i
Берліні	b ɛ r lʲ i n̪ʲ i
найдеш	n̪ ɑ j d̪ ɛ ʃ
стріла	s̪ t̪ rʲ i l̪ ɑ
серцем	s̪ ɛ r t̪s̪ ɛ m
майдані	m ɑ j d̪ ɑ n̪ʲ i
потреби	p ɔ t̪ r ɛ b ɪ
адронний	ɑ d̪ r ɔ n̪ n̪ ɪ j
колайдер	k ɔ l̪ ɑ j d̪ ɛ r
двісті	d̪ v i s̪ t̪ i
кримінальна	k r ɪ m i n̪ ɑ lʲ n̪ ɑ
втрата	v t̪ r ɑ t̪ ɑ
імперії	i m p ɛ rʲ i j i
Путін	p u t̪ i n̪
канал	k ɑ n̪ ɑ l̪
гол	ɦ ɔ l̪
іспанцям	i s̪ p ɑ n̪ t̪s̪ʲ ɑ m
Швецією	ʃ v ɛ t̪s̪ʲ i ɛ u
круглий	k r u ɦ l̪ ɪ j
стіл	s̪ t̪ i l̪
літературні	lʲ i t̪ ɛ r ɑ t̪ u r n̪ʲ i
капусту	k ɑ p u s̪ t̪ u
посікли	p ɔ s̪ i k l̪ ɪ
точки	t̪ ɔ t̪ ʃ k ɪ
зору	z̪ ɔ r u
смерть	s̪ m ɛ r t̪
колишнього	k ɔ l̪ ɪ ʃ n̪ʲ ɔ ɦ ɔ
перейти	p ɛ r ɛ j t̪ ɪ
українську	u k r ɑ j i n̪ s̪ k u
стався	s̪ t̪ ɑ v s̪ ɑ
потужний	p ɔ t̪ u ʒ n̪ ɪ j
землетрус	z̪ ɛ m l̪ ɛ t̪ r u s̪
теренах	t̪ ɛ r ɛ n̪ ɑ x
ста	s̪ t̪ ɑ
матеріальні	m ɑ t̪ ɛ rʲ i ɑ lʲ n̪ʲ i
світовий	s̪ v i t̪ ɔ v ɪ j
створюються	s̪ t̪ v ɔ rʲ u u t̪ s̪ ɑ
домашніх	d̪ ɔ m ɑ ʃ n̪ʲ i x
контролює	k ɔ n̪ t̪ r ɔ lʲ u ɛ
валютного	v ɑ lʲ u t̪ n̪ ɔ ɦ ɔ
ім	i m
Степана	s̪ t̪ ɛ p ɑ n̪ ɑ
Бандери	b ɑ n̪ d̪ ɛ r ɪ
рідного	rʲ i d̪ n̪ ɔ ɦ ɔ
легендарний	l̪ ɛ ɦ ɛ n̪ d̪ ɑ r n̪ ɪ j
голкіпер	ɦ ɔ l̪ k i p ɛ r
Торпедо	t̪ ɔ r p ɛ d̪ ɔ
зберігається	z̪ b ɛ rʲ i ɦ ɑ ɛ t̪ s̪ ɑ
вівторок	v i v t̪ ɔ r ɔ k
сказали	s̪ k ɑ z̪ ɑ l̪ ɪ
платник	p l̪ ɑ t̪ n̪ ɪ k
акцизного	ɑ k t̪s̪ ɪ z̪ n̪ ɔ ɦ ɔ
збору	z̪ b ɔ r u
проектом	p r ɔ ɛ k t̪ ɔ m
загальна	z̪ ɑ ɦ ɑ lʲ n̪ ɑ
зрозуміє	z̪ r ɔ z̪ u m i ɛ
члени	t̪ ʃ l̪ ɛ n̪ ɪ
змішаній	z̪ m i ʃ ɑ n̪ʲ i j
естафеті	ɛ s̪ t̪ ɑ f ɛ t̪ i
складає	s̪ k l̪ ɑ d̪ ɑ ɛ
рятувальники	rʲ ɑ t̪ u v ɑ lʲ n̪ ɪ k ɪ
очікувати	ɔ t̪ ʃ i k u v ɑ t̪ ɪ
наступні	n̪ ɑ s̪ t̪ u p n̪ʲ i
протистояння	p r ɔ t̪ ɪ s̪ t̪ ɔ ɑ n̪ n̪ʲ ɑ
зафіксовано	z̪ ɑ f i k s̪ ɔ v ɑ n̪ ɔ
найчастіше	n̪ ɑ j t̪ ʃ ɑ s̪ t̪ i ʃ ɛ
будь	b u d̪ʲ
Заходу	z̪ ɑ x ɔ d̪ u
Анрі	ɑ n̪ rʲ i
Арсенал	ɑ r s̪ ɛ n̪ ɑ l̪
переконання	p ɛ r ɛ k ɔ n̪ ɑ n̪ n̪ʲ ɑ
кампанії	k ɑ m p ɑ n̪ʲ i j i
пана	p ɑ n̪ ɑ
Костянтина	k ɔ s̪ t̪ ɑ n̪ t̪ ɪ n̪ ɑ
скаже	s̪ k ɑ ʒ ɛ
навчальних	n̪ ɑ v t̪ ʃ ɑ lʲ n̪ ɪ x
закладах	z̪ ɑ k l̪ ɑ d̪ ɑ x
Пінчук	p i n̪ t̪ ʃ u k
основі	ɔ s̪ n̪ ɔ v i
картині	k ɑ r t̪ ɪ n̪ʲ i
зображені	z̪ ɔ b r ɑ ʒ ɛ n̪ʲ i
вечеряють	v ɛ t̪ ʃ ɛ rʲ ɑ u t̪
моїй	m ɔ j i j
все–таки	v s̪ ɛ t̪ ɑ k ɪ
тем	t̪ ɛ m
будинки	b u d̪ ɪ n̪ k ɪ
потрапляють	p ɔ t̪ r ɑ p lʲ ɑ u t̪
пояснив	p ɔ ɑ s̪ n̪ ɪ v
Тернополі	t̪ ɛ r n̪ ɔ p ɔ lʲ i
оо	ɔ ɔ
комплекс	k ɔ m p l̪ ɛ k s̪
здобути	z̪ d̪ ɔ b u t̪ ɪ
щосереди	ʃ t̪ ʃ ɔ s̪ ɛ r ɛ d̪ ɪ
телеканалі	t̪ ɛ l̪ ɛ k ɑ n̪ ɑ lʲ i
побачила	p ɔ b ɑ t̪ ʃ ɪ l̪ ɑ
ціна	t̪s̪ʲ i n̪ ɑ
доки	d̪ ɔ k ɪ
спромігся	s̪ p r ɔ m i ɦ s̪ ɑ
належним	n̪ ɑ l̪ ɛ ʒ n̪ ɪ m
управління	u p r ɑ v lʲ i n̪ n̪ʲ ɑ
попереду	p ɔ p ɛ r ɛ d̪ u
продовжую	p r ɔ d̪ ɔ v ʒ u u
кричати	k r ɪ t̪ ʃ ɑ t̪ ɪ
безмежна	b ɛ z̪ m ɛ ʒ n̪ ɑ
пуста	p u s̪ t̪ ɑ
еее	ɛ ɛ ɛ
сліду	s̪ lʲ i d̪ u
зустрінемося	z̪ u s̪ t̪ rʲ i n̪ ɛ m ɔ s̪ ɑ
виплати	v ɪ p l̪ ɑ t̪ ɪ
списання	s̪ p ɪ s̪ ɑ n̪ n̪ʲ ɑ
просив	p r ɔ s̪ ɪ v
Ліна	lʲ i n̪ ɑ
п'яту	p j ɑ t̪ u
позиції	p ɔ z̪ ɪ t̪s̪ʲ i j i
перегляду	p ɛ r ɛ ɦ lʲ ɑ d̪ u
важливою	v ɑ ʒ l̪ ɪ v ɔ u
палкий	p ɑ l̪ k ɪ j
бистрий	b ɪ s̪ t̪ r ɪ j
блискавка	b l̪ ɪ s̪ k ɑ v k ɑ
важливе	v ɑ ʒ l̪ ɪ v ɛ
спілкування	s̪ p i l̪ k u v ɑ n̪ n̪ʲ ɑ
увагою	u v ɑ ɦ ɔ u
теплопостачання	t̪ ɛ p l̪ ɔ p ɔ s̪ t̪ ɑ t̪ ʃ ɑ n̪ n̪ʲ ɑ
прекрасне	p r ɛ k r ɑ s̪ n̪ ɛ
приймемо	p r ɪ j m ɛ m ɔ
обсяг	ɔ b s̪ ɑ ɦ
розташоване	r ɔ z̪ t̪ ɑ ʃ ɔ v ɑ n̪ ɛ
пунктом	p u n̪ k t̪ ɔ m
скоріше	s̪ k ɔ rʲ i ʃ ɛ
земельну	z̪ ɛ m ɛ lʲ n̪ u
восьме	v ɔ s̪ m ɛ
одинадцятого	ɔ d̪ ɪ n̪ ɑ d̪ t̪s̪ʲ ɑ t̪ ɔ ɦ ɔ
можливе	m ɔ ʒ l̪ ɪ v ɛ
невдоволення	n̪ ɛ v d̪ ɔ v ɔ l̪ ɛ n̪ n̪ʲ ɑ
приходу	p r ɪ x ɔ d̪ u
учні	u t̪ ʃ n̪ʲ i
відвідати	v i d̪ v i d̪ ɑ t̪ ɪ
селища	s̪ ɛ l̪ ɪ ʃ t̪ ʃ ɑ
мешканців	m ɛ ʃ k ɑ n̪ t̪s̪ʲ i v
російському	r ɔ s̪ i j s̪ k ɔ m u
подібних	p ɔ d̪ʲ i b n̪ ɪ x
рекордів	r ɛ k ɔ r d̪ʲ i v
ОУН	ɔ u n̪
західних	z̪ ɑ x i d̪ n̪ ɪ x
лютому	lʲ u t̪ ɔ m u
виповнилося	v ɪ p ɔ v n̪ ɪ l̪ ɔ s̪ ɑ
величезні	v ɛ l̪ ɪ t̪ ʃ ɛ z̪ n̪ʲ i
інвесторів	i n̪ v ɛ s̪ t̪ ɔ rʲ i v
людських	lʲ u d̪ s̪ k ɪ x
картини	k ɑ r t̪ ɪ n̪ ɪ
сини	s̪ ɪ n̪ ɪ
історією	i s̪ t̪ ɔ rʲ i ɛ u
краю	k r ɑ u
сезону	s̪ ɛ z̪ ɔ n̪ u
Петро	p ɛ t̪ r ɔ
одсунувся	ɔ d̪ s̪ u n̪ u v s̪ ɑ
край	k r ɑ j
наступна	n̪ ɑ s̪ t̪ u p n̪ ɑ
селяни	s̪ ɛ lʲ ɑ n̪ ɪ
формувати	f ɔ r m u v ɑ t̪ ɪ
громадську	ɦ r ɔ m ɑ d̪ s̪ k u
призначення	p r ɪ z̪ n̪ ɑ t̪ ʃ ɛ n̪ n̪ʲ ɑ
главою	ɦ l̪ ɑ v ɔ u
рейтингу	r ɛ j t̪ ɪ n̪ ɦ u
Союз	s̪ ɔ u z̪
газету	ɦ ɑ z̪ ɛ t̪ u
сучасні	s̪ u t̪ ʃ ɑ s̪ n̪ʲ i
дефіциту	d̪ ɛ f i t̪s̪ ɪ t̪ u
можливі	m ɔ ʒ l̪ ɪ v i
департаменту	d̪ ɛ p ɑ r t̪ ɑ m ɛ n̪ t̪ u
вугільної	v u ɦ i lʲ n̪ ɔ j i
палива	p ɑ l̪ ɪ v ɑ
енергетики	ɛ n̪ ɛ r ɦ ɛ t̪ ɪ k ɪ
команд	k ɔ m ɑ n̪ d̪
забити	z̪ ɑ b ɪ t̪ ɪ
вірші	v i r ʃ i
назвою	n̪ ɑ z̪ v ɔ u
запитав	z̪ ɑ p ɪ t̪ ɑ v
оплати	ɔ p l̪ ɑ t̪ ɪ
судді	s̪ u d̪ d̪ʲ i
КС	k s̪
товариш	t̪ ɔ v ɑ r ɪ ʃ
Мельниченко	m ɛ lʲ n̪ ɪ t̪ ʃ ɛ n̪ k ɔ
пріоритети	p rʲ i ɔ r ɪ t̪ ɛ t̪ ɪ
НСК	n̪ s̪ k
Олімпійський	ɔ lʲ i m p i j s̪ k ɪ j
унікальна	u n̪ʲ i k ɑ lʲ n̪ ɑ
тринадцятий	t̪ r ɪ n̪ ɑ d̪ t̪s̪ʲ ɑ t̪ ɪ j
називали	n̪ ɑ z̪ ɪ v ɑ l̪ ɪ
чотирнадцятим	t̪ ʃ ɔ t̪ ɪ r n̪ ɑ d̪ t̪s̪ʲ ɑ t̪ ɪ m
вимог	v ɪ m ɔ ɦ
читаю	t̪ ʃ ɪ t̪ ɑ u
вільно	v i lʲ n̪ ɔ
викликало	v ɪ k l̪ ɪ k ɑ l̪ ɔ
причиною	p r ɪ t̪ ʃ ɪ n̪ ɔ u
загострення	z̪ ɑ ɦ ɔ s̪ t̪ r ɛ n̪ n̪ʲ ɑ
Економічної	ɛ k ɔ n̪ ɔ m i t̪ ʃ n̪ ɔ j i
спершу	s̪ p ɛ r ʃ u
висловити	v ɪ s̪ l̪ ɔ v ɪ t̪ ɪ
повідомляла	p ɔ v i d̪ ɔ m lʲ ɑ l̪ ɑ
жорстоко	ʒ ɔ r s̪ t̪ ɔ k ɔ
побили	p ɔ b ɪ l̪ ɪ
кинули	k ɪ n̪ u l̪ ɪ
станції	s̪ t̪ ɑ n̪ t̪s̪ʲ i j i
футбольній	f u t̪ b ɔ lʲ n̪ʲ i j
грають	ɦ r ɑ u t̪
одинадцять	ɔ d̪ ɪ n̪ ɑ d̪ t̪s̪ʲ ɑ t̪
гравців	ɦ r ɑ v t̪s̪ʲ i v
відбудуться	v i d̪ b u d̪ u t̪ s̪ ɑ
монастиря	m ɔ n̪ ɑ s̪ t̪ ɪ rʲ ɑ
смертю	s̪ m ɛ r t̪ u
великим	v ɛ l̪ ɪ k ɪ m
сільради	s̪ i lʲ r ɑ d̪ ɪ
кращим	k r ɑ ʃ t̪ ʃ ɪ m
фахівці	f ɑ x i v t̪s̪ʲ i
їду	j i d̪ u
здоров'ям	z̪ d̪ ɔ r ɔ v j ɑ m
м	m
їхньому	j i x n̪ʲ ɔ m u
тривалий	t̪ r ɪ v ɑ l̪ ɪ j
оголосила	ɔ ɦ ɔ l̪ ɔ s̪ ɪ l̪ ɑ
донька	d̪ ɔ n̪ʲ k ɑ
Олеся	ɔ l̪ ɛ s̪ ɑ
каміння	k ɑ m i n̪ n̪ʲ ɑ
стають	s̪ t̪ ɑ u t̪
презентації	p r ɛ z̪ ɛ n̪ t̪ ɑ t̪s̪ʲ i j i
саму	s̪ ɑ m u
глибоко	ɦ l̪ ɪ b ɔ k ɔ
зателефонував	z̪ ɑ t̪ ɛ l̪ ɛ f ɔ n̪ u v ɑ v
технології	t̪ ɛ x n̪ ɔ l̪ ɔ ɦ i j i
Родина	r ɔ d̪ ɪ n̪ ɑ
запам'ятав	z̪ ɑ p ɑ m j ɑ t̪ ɑ v
назв	n̪ ɑ z̪ v
висловив	v ɪ s̪ l̪ ɔ v ɪ v
Сьомін	s̪ ɔ m i n̪
нестабільності	n̪ ɛ s̪ t̪ ɑ b i lʲ n̪ ɔ s̪ t̪ i
століть	s̪ t̪ ɔ lʲ i t̪
євроінтеграції	j ɛ v r ɔ i n̪ t̪ ɛ ɦ r ɑ t̪s̪ʲ i j i
отримують	ɔ t̪ r ɪ m u u t̪
зарплату	z̪ ɑ r p l̪ ɑ t̪ u
запит	z̪ ɑ p ɪ t̪
Русь	r u s̪
закони	z̪ ɑ k ɔ n̪ ɪ
чемпіона	t̪ ʃ ɛ m p i ɔ n̪ ɑ
робиш	r ɔ b ɪ ʃ
органах	ɔ r ɦ ɑ n̪ ɑ x
Ворскли	v ɔ r s̪ k l̪ ɪ
невістку	n̪ ɛ v i s̪ t̪ k u
кричать	k r ɪ t̪ ʃ ɑ t̪
Михайличенко	m ɪ x ɑ j l̪ ɪ t̪ ʃ ɛ n̪ k ɔ
ресторан	r ɛ s̪ t̪ ɔ r ɑ n̪
Олімпійському	ɔ lʲ i m p i j s̪ k ɔ m u
наполегливо	n̪ ɑ p ɔ l̪ ɛ ɦ l̪ ɪ v ɔ
настрій	n̪ ɑ s̪ t̪ rʲ i j
декількох	d̪ ɛ k i lʲ k ɔ x
кацапи	k ɑ t̪s̪ ɑ p ɪ
підняли	p i d̪ n̪ʲ ɑ l̪ ɪ
москалів	m ɔ s̪ k ɑ lʲ i v
вісімнадцята	v i s̪ i m n̪ ɑ d̪ t̪s̪ʲ ɑ t̪ ɑ
містить	m i s̪ t̪ ɪ t̪
Ніна	n̪ʲ i n̪ ɑ
народів	n̪ ɑ r ɔ d̪ʲ i v
погляди	p ɔ ɦ lʲ ɑ d̪ ɪ
масової	m ɑ s̪ ɔ v ɔ j i
держадміністрації	d̪ ɛ r ʒ ɑ d̪ m i n̪ʲ i s̪ t̪ r ɑ t̪s̪ʲ i j i
порятунку	p ɔ rʲ ɑ t̪ u n̪ k u
обмежує	ɔ b m ɛ ʒ u ɛ
орієнтація	ɔ rʲ i ɛ n̪ t̪ ɑ t̪s̪ʲ i ɑ
перегонів	p ɛ r ɛ ɦ ɔ n̪ʲ i v
Одеси	ɔ d̪ ɛ s̪ ɪ
вступу	v s̪ t̪ u p u
п'ятім	p j ɑ t̪ i m
ВР	v r
пані	p ɑ n̪ʲ i
гарячому	ɦ ɑ rʲ ɑ t̪ ʃ ɔ m u
заборонено	z̪ ɑ b ɔ r ɔ n̪ ɛ n̪ ɔ
відмовилася	v i d̪ m ɔ v ɪ l̪ ɑ s̪ ɑ
закликає	z̪ ɑ k l̪ ɪ k ɑ ɛ
млина	m l̪ ɪ n̪ ɑ
розходилась	r ɔ z̪ x ɔ d̪ ɪ l̪ ɑ s̪
поралась	p ɔ r ɑ l̪ ɑ s̪
городини	ɦ ɔ r ɔ d̪ ɪ n̪ ɪ
талант	t̪ ɑ l̪ ɑ n̪ t̪
історичну	i s̪ t̪ ɔ r ɪ t̪ ʃ n̪ u
середині	s̪ ɛ r ɛ d̪ ɪ n̪ʲ i
спільної	s̪ p i lʲ n̪ ɔ j i
ідентичності	i d̪ ɛ n̪ t̪ ɪ t̪ ʃ n̪ ɔ s̪ t̪ i
шахті	ʃ ɑ x t̪ i
доктор	d̪ ɔ k t̪ ɔ r
історичних	i s̪ t̪ ɔ r ɪ t̪ ʃ n̪ ɪ x
перехід	p ɛ r ɛ x i d̪
літній	lʲ i t̪ n̪ʲ i j
виступали	v ɪ s̪ t̪ u p ɑ l̪ ɪ
чорний	t̪ ʃ ɔ r n̪ ɪ j
шовковий	ʃ ɔ v k ɔ v ɪ j
пух	p u x
висипався	v ɪ s̪ ɪ p ɑ v s̪ ɑ
верхній	v ɛ r x n̪ʲ i j
губі	ɦ u b i
русифікованих	r u s̪ ɪ f i k ɔ v ɑ n̪ ɪ x
внести	v n̪ ɛ s̪ t̪ ɪ
чинного	t̪ ʃ ɪ n̪ n̪ ɔ ɦ ɔ
чемпіонаті	t̪ ʃ ɛ m p i ɔ n̪ ɑ t̪ i
попиту	p ɔ p ɪ t̪ u
широкі	ʃ ɪ r ɔ k i
високі	v ɪ s̪ ɔ k i
усієї	u s̪ i ɛ j i
Наталі	n̪ ɑ t̪ ɑ lʲ i
Крим	k r ɪ m
триста	t̪ r ɪ s̪ t̪ ɑ
листів	l̪ ɪ s̪ t̪ i v
продала	p r ɔ d̪ ɑ l̪ ɑ
якій	j ɑ k i j
зал	z̪ ɑ l̪
Дніпропетровщині	d̪ n̪ʲ i p r ɔ p ɛ t̪ r ɔ v ʃ t̪ ʃ ɪ n̪ʲ i
приїзду	p r ɪ j i z̪ d̪ u
Донецька	d̪ ɔ n̪ ɛ t̪s̪ʲ k ɑ
найближчі	n̪ ɑ j b l̪ ɪ ʒ t̪ ʃ i
тім	t̪ i m
ведуть	v ɛ d̪ u t̪
земляків	z̪ ɛ m lʲ ɑ k i v
роками	r ɔ k ɑ m ɪ
становлять	s̪ t̪ ɑ n̪ ɔ v lʲ ɑ t̪
слухали	s̪ l̪ u x ɑ l̪ ɪ
основному	ɔ s̪ n̪ ɔ v n̪ ɔ m u
конкурсі	k ɔ n̪ k u r s̪ i
радянського	r ɑ d̪ʲ ɑ n̪ s̪ k ɔ ɦ ɔ
липні	l̪ ɪ p n̪ʲ i
показників	p ɔ k ɑ z̪ n̪ ɪ k i v
Хайльброні	x ɑ j lʲ b r ɔ n̪ʲ i
вимагати	v ɪ m ɑ ɦ ɑ t̪ ɪ
зізнався	z̪ʲ i z̪ n̪ ɑ v s̪ ɑ
керувати	k ɛ r u v ɑ t̪ ɪ
проїдання	p r ɔ j i d̪ ɑ n̪ n̪ʲ ɑ
гальмують	ɦ ɑ lʲ m u u t̪
Редакція	r ɛ d̪ ɑ k t̪s̪ʲ i ɑ
ЕП	ɛ p
питанні	p ɪ t̪ ɑ n̪ n̪ʲ i
порушенні	p ɔ r u ʃ ɛ n̪ n̪ʲ i
Київрада	k ɪ j i v r ɑ d̪ ɑ
різдва	rʲ i z̪ d̪ v ɑ
Ярмоленко	j ɑ r m ɔ l̪ ɛ n̪ k ɔ
багатенькому	b ɑ ɦ ɑ t̪ ɛ n̪ʲ k ɔ m u
зміст	z̪ m i s̪ t̪
монумент	m ɔ n̪ u m ɛ n̪ t̪
щоп'ятниці	ʃ t̪ ʃ ɔ p j ɑ t̪ n̪ ɪ t̪s̪ʲ i
Інтері	i n̪ t̪ ɛ rʲ i
Кисельовим	k ɪ s̪ ɛ lʲ ɔ v ɪ m
облаштування	ɔ b l̪ ɑ ʃ t̪ u v ɑ n̪ n̪ʲ ɑ
кордону	k ɔ r d̪ ɔ n̪ u
здобуває	z̪ d̪ ɔ b u v ɑ ɛ
бронзу	b r ɔ n̪ z̪ u
юніорському	j u n̪ʲ i ɔ r s̪ k ɔ m u
міксті	m i k s̪ t̪ i
липневих	l̪ ɪ p n̪ ɛ v ɪ x
доленосними	d̪ ɔ l̪ ɛ n̪ ɔ s̪ n̪ ɪ m ɪ
конкурс	k ɔ n̪ k u r s̪
Єгипту	j ɛ ɦ ɪ p t̪ u
більшу	b i lʲ ʃ u
жертвами	ʒ ɛ r t̪ v ɑ m ɪ
виявилися	v ɪ ɑ v ɪ l̪ ɪ s̪ ɑ
підбирала	p i d̪ b ɪ r ɑ l̪ ɑ
колір	k ɔ lʲ i r
мимоволі	m ɪ m ɔ v ɔ lʲ i
жаль	ʒ ɑ lʲ
загиблого	z̪ ɑ ɦ ɪ b l̪ ɔ ɦ ɔ
сотень	s̪ ɔ t̪ ɛ n̪ʲ
Галичині	ɦ ɑ l̪ ɪ t̪ ʃ ɪ n̪ʲ i
Іспанії	i s̪ p ɑ n̪ʲ i j i
автомобілі	ɑ v t̪ ɔ m ɔ b i lʲ i
людства	lʲ u d̪ s̪ t̪ v ɑ
готує	ɦ ɔ t̪ u ɛ
закінчення	z̪ ɑ k i n̪ t̪ ʃ ɛ n̪ n̪ʲ ɑ
конференції	k ɔ n̪ f ɛ r ɛ n̪ t̪s̪ʲ i j i
доповіді	d̪ ɔ p ɔ v i d̪ʲ i
базу	b ɑ z̪ u
силою	s̪ ɪ l̪ ɔ u
двері	d̪ v ɛ rʲ i
спостерігали	s̪ p ɔ s̪ t̪ ɛ rʲ i ɦ ɑ l̪ ɪ
представництва	p r ɛ d̪ s̪ t̪ ɑ v n̪ ɪ t̪s̪ t̪ v ɑ
заходів	z̪ ɑ x ɔ d̪ʲ i v
проголосувати	p r ɔ ɦ ɔ l̪ ɔ s̪ u v ɑ t̪ ɪ
масові	m ɑ s̪ ɔ v i
лісу	lʲ i s̪ u
будинок	b u d̪ ɪ n̪ ɔ k
Донецьк	d̪ ɔ n̪ ɛ t̪s̪ʲ k
тролейбусів	t̪ r ɔ l̪ ɛ j b u s̪ i v
загроз	z̪ ɑ ɦ r ɔ z̪
бачите	b ɑ t̪ ʃ ɪ t̪ ɛ
жінкою	ʒ i n̪ k ɔ u
запровадити	z̪ ɑ p r ɔ v ɑ d̪ ɪ t̪ ɪ
європейські	j ɛ v r ɔ p ɛ j s̪ k i
порозі	p ɔ r ɔ z̪ʲ i
принесе	p r ɪ n̪ ɛ s̪ ɛ
білі	b i lʲ i
айстри	ɑ j s̪ t̪ r ɪ
намагаюся	n̪ ɑ m ɑ ɦ ɑ u s̪ ɑ
хабарі	x ɑ b ɑ rʲ i
грали	ɦ r ɑ l̪ ɪ
кореспондент	k ɔ r ɛ s̪ p ɔ n̪ d̪ ɛ n̪ t̪
медом	m ɛ d̪ ɔ m
побігли	p ɔ b i ɦ l̪ ɪ
верб	v ɛ r b
випереджаючи	v ɪ p ɛ r ɛ d̪ ʒ ɑ u t̪ ʃ ɪ
уха	u x ɑ
науковий	n̪ ɑ u k ɔ v ɪ j
випробування	v ɪ p r ɔ b u v ɑ n̪ n̪ʲ ɑ
Луганська	l̪ u ɦ ɑ n̪ s̪ k ɑ
віддала	v i d̪ d̪ ɑ l̪ ɑ
порушенням	p ɔ r u ʃ ɛ n̪ n̪ʲ ɑ m
позитивні	p ɔ z̪ ɪ t̪ ɪ v n̪ʲ i
сим	s̪ ɪ m
боком	b ɔ k ɔ m
настягаєтесь	n̪ ɑ s̪ t̪ ɑ ɦ ɑ ɛ t̪ ɛ s̪
зиму	z̪ ɪ m u
уточнив	u t̪ ɔ t̪ ʃ n̪ ɪ v
купити	k u p ɪ t̪ ɪ
продукти	p r ɔ d̪ u k t̪ ɪ
державною	d̪ ɛ r ʒ ɑ v n̪ ɔ u
єдності	j ɛ d̪ n̪ ɔ s̪ t̪ i
тлі	t̪ lʲ i
демонструє	d̪ ɛ m ɔ n̪ s̪ t̪ r u ɛ
шо	ʃ ɔ
дитячі	d̪ ɪ t̪ ɑ t̪ ʃ i
експорту	ɛ k s̪ p ɔ r t̪ u
опозиція	ɔ p ɔ z̪ ɪ t̪s̪ʲ i ɑ
настала	n̪ ɑ s̪ t̪ ɑ l̪ ɑ
приватному	p r ɪ v ɑ t̪ n̪ ɔ m u
зоопарку	z̪ ɔ ɔ p ɑ r k u
Шевченківського	ʃ ɛ v t̪ ʃ ɛ n̪ k i v s̪ k ɔ ɦ ɔ
лауреата	l̪ ɑ u r ɛ ɑ t̪ ɑ
особистий	ɔ s̪ ɔ b ɪ s̪ t̪ ɪ j
ліс	lʲ i s̪
проведено	p r ɔ v ɛ d̪ ɛ n̪ ɔ
безоплатно	b ɛ z̪ ɔ p l̪ ɑ t̪ n̪ ɔ
Уругвай	u r u ɦ v ɑ j
атак	ɑ t̪ ɑ k
бюджеті	b u d̪ ʒ ɛ t̪ i
найкращих	n̪ ɑ j k r ɑ ʃ t̪ ʃ ɪ x
працівники	p r ɑ t̪s̪ʲ i v n̪ ɪ k ɪ
кермом	k ɛ r m ɔ m
вересні	v ɛ r ɛ s̪ n̪ʲ i
поранення	p ɔ r ɑ n̪ ɛ n̪ n̪ʲ ɑ
зазначила	z̪ ɑ z̪ n̪ ɑ t̪ ʃ ɪ l̪ ɑ
комплексу	k ɔ m p l̪ ɛ k s̪ u
каналу	k ɑ n̪ ɑ l̪ u
срібла	s̪ rʲ i b l̪ ɑ
предметом	p r ɛ d̪ m ɛ t̪ ɔ m
Бундестагу	b u n̪ d̪ ɛ s̪ t̪ ɑ ɦ u
четвертий	t̪ ʃ ɛ t̪ v ɛ r t̪ ɪ j
Київстар	k ɪ j i v s̪ t̪ ɑ r
резон	r ɛ z̪ ɔ n̪
помізкувати	p ɔ m i z̪ k u v ɑ t̪ ɪ
готовність	ɦ ɔ t̪ ɔ v n̪ʲ i s̪ t̪
частині	t̪ ʃ ɑ s̪ t̪ ɪ n̪ʲ i
НАК	n̪ ɑ k
Нафтогаз	n̪ ɑ f t̪ ɔ ɦ ɑ z̪
західні	z̪ ɑ x i d̪ n̪ʲ i
дев'ятнадцята	d̪ ɛ v j ɑ t̪ n̪ ɑ d̪ t̪s̪ʲ ɑ t̪ ɑ
Партія	p ɑ r t̪ i ɑ
планує	p l̪ ɑ n̪ u ɛ
ЦСКА	t̪s̪ s̪ k ɑ
Реалом	r ɛ ɑ l̪ ɔ m
Союзу	s̪ ɔ u z̪ u
Податковий	p ɔ d̪ ɑ t̪ k ɔ v ɪ j
кодекс	k ɔ d̪ ɛ k s̪
боків	b ɔ k i v
суттєво	s̪ u t̪ t̪ ɛ v ɔ
збільшить	z̪ b i lʲ ʃ ɪ t̪
важливих	v ɑ ʒ l̪ ɪ v ɪ x
експерт	ɛ k s̪ p ɛ r t̪
обійдеться	ɔ b i j d̪ ɛ t̪ s̪ ɑ
кримських	k r ɪ m s̪ k ɪ x
механізм	m ɛ x ɑ n̪ʲ i z̪ m
зміцнення	z̪ m i t̪s̪ n̪ ɛ n̪ n̪ʲ ɑ
другої	d̪ r u ɦ ɔ j i
Карлсруе	k ɑ r l̪ s̪ r u ɛ
вважаються	v v ɑ ʒ ɑ u t̪ s̪ ɑ
зниклими	z̪ n̪ ɪ k l̪ ɪ m ɪ
безвісти	b ɛ z̪ v i s̪ t̪ ɪ
пригадує	p r ɪ ɦ ɑ d̪ u ɛ
співвідношення	s̪ p i v v i d̪ n̪ ɔ ʃ ɛ n̪ n̪ʲ ɑ
викликає	v ɪ k l̪ ɪ k ɑ ɛ
командних	k ɔ m ɑ n̪ d̪ n̪ ɪ x
вправах	v p r ɑ v ɑ x
українки	u k r ɑ j i n̪ k ɪ
третіми	t̪ r ɛ t̪ i m ɪ
угоду	u ɦ ɔ d̪ u
столичних	s̪ t̪ ɔ l̪ ɪ t̪ ʃ n̪ ɪ x
ринках	r ɪ n̪ k ɑ x
вспіла	v s̪ p i l̪ ɑ
накинути	n̪ ɑ k ɪ n̪ u t̪ ɪ
сильний	s̪ ɪ lʲ n̪ ɪ j
подавати	p ɔ d̪ ɑ v ɑ t̪ ɪ
ДПС	d̪ p s̪
намагаємося	n̪ ɑ m ɑ ɦ ɑ ɛ m ɔ s̪ ɑ
позитивний	p ɔ z̪ ɪ t̪ ɪ v n̪ ɪ j
подивився	p ɔ d̪ ɪ v ɪ v s̪ ɑ
папір	p ɑ p i r
розправив	r ɔ z̪ p r ɑ v ɪ v
прочитав	p r ɔ t̪ ʃ ɪ t̪ ɑ v
зложив	z̪ l̪ ɔ ʒ ɪ v
вихідних	v ɪ x i d̪ n̪ ɪ x
Спілки	s̪ p i l̪ k ɪ
високого	v ɪ s̪ ɔ k ɔ ɦ ɔ
низького	n̪ ɪ z̪ʲ k ɔ ɦ ɔ
зросту	z̪ r ɔ s̪ t̪ u
двадцятка	d̪ v ɑ d̪ t̪s̪ʲ ɑ t̪ k ɑ
добиралося	d̪ ɔ b ɪ r ɑ l̪ ɔ s̪ ɑ
післязавтра	p i s̪ lʲ ɑ z̪ ɑ v t̪ r ɑ
олігархів	ɔ lʲ i ɦ ɑ r x i v
відкритим	v i d̪ k r ɪ t̪ ɪ m
структуру	s̪ t̪ r u k t̪ u r u
загальних	z̪ ɑ ɦ ɑ lʲ n̪ ɪ x
увесь	u v ɛ s̪
дівчинко	d̪ʲ i v t̪ ʃ ɪ n̪ k ɔ
печальна	p ɛ t̪ ʃ ɑ lʲ n̪ ɑ
доле	d̪ ɔ l̪ ɛ
Китаї	k ɪ t̪ ɑ j i
третину	t̪ r ɛ t̪ ɪ n̪ u
сприяє	s̪ p r ɪ ɑ ɛ
паспорти	p ɑ s̪ p ɔ r t̪ ɪ
збори	z̪ b ɔ r ɪ
одні	ɔ d̪ n̪ʲ i
культурного	k u lʲ t̪ u r n̪ ɔ ɦ ɔ
становлення	s̪ t̪ ɑ n̪ ɔ v l̪ ɛ n̪ n̪ʲ ɑ
демократичні	d̪ ɛ m ɔ k r ɑ t̪ ɪ t̪ ʃ n̪ʲ i
бібліотеці	b i b lʲ i ɔ t̪ ɛ t̪s̪ʲ i
очіпок	ɔ t̪ ʃ i p ɔ k
подався	p ɔ d̪ ɑ v s̪ ɑ
набік	n̪ ɑ b i k
якими	j ɑ k ɪ m ɪ
вашої	v ɑ ʃ ɔ j i
організованою	ɔ r ɦ ɑ n̪ʲ i z̪ ɔ v ɑ n̪ ɔ u
злочинністю	z̪ l̪ ɔ t̪ ʃ ɪ n̪ n̪ʲ i s̪ t̪ u
третьому	t̪ r ɛ t̪ ɔ m u
зазнав	z̪ ɑ z̪ n̪ ɑ v
поразки	p ɔ r ɑ z̪ k ɪ
похорону	p ɔ x ɔ r ɔ n̪ u
селян	s̪ ɛ lʲ ɑ n̪
скарги	s̪ k ɑ r ɦ ɪ
формально	f ɔ r m ɑ lʲ n̪ ɔ
розпочалася	r ɔ z̪ p ɔ t̪ ʃ ɑ l̪ ɑ s̪ ɑ
дискусія	d̪ ɪ s̪ k u s̪ i ɑ
вичерпується	v ɪ t̪ ʃ ɛ r p u ɛ t̪ s̪ ɑ
позитив	p ɔ z̪ ɪ t̪ ɪ v
діях	d̪ʲ i ɑ x
регіоналів	r ɛ ɦ i ɔ n̪ ɑ lʲ i v
вигляді	v ɪ ɦ lʲ ɑ d̪ʲ i
району	r ɑ j ɔ n̪ u
двадцяти	d̪ v ɑ d̪ t̪s̪ʲ ɑ t̪ ɪ
оголошення	ɔ ɦ ɔ l̪ ɔ ʃ ɛ n̪ n̪ʲ ɑ
повідомляють	p ɔ v i d̪ ɔ m lʲ ɑ u t̪
опозиційних	ɔ p ɔ z̪ ɪ t̪s̪ʲ i j n̪ ɪ x
активістів	ɑ k t̪ ɪ v i s̪ t̪ i v
тиск	t̪ ɪ s̪ k
Радянського	r ɑ d̪ʲ ɑ n̪ s̪ k ɔ ɦ ɔ
газети	ɦ ɑ z̪ ɛ t̪ ɪ
Чорноморські	t̪ ʃ ɔ r n̪ ɔ m ɔ r s̪ k i
пропонує	p r ɔ p ɔ n̪ u ɛ
ставляться	s̪ t̪ ɑ v lʲ ɑ t̪ s̪ ɑ
Америки	ɑ m ɛ r ɪ k ɪ
міжнародних	m i ʒ n̪ ɑ r ɔ d̪ n̪ ɪ x
Рубін	r u b i n̪
голів	ɦ ɔ lʲ i v
забили	z̪ ɑ b ɪ l̪ ɪ
Законом	z̪ ɑ k ɔ n̪ ɔ m
експлуатацію	ɛ k s̪ p l̪ u ɑ t̪ ɑ t̪s̪ʲ i u
частіше	t̪ ʃ ɑ s̪ t̪ i ʃ ɛ
Донеччини	d̪ ɔ n̪ ɛ t̪ ʃ t̪ ʃ ɪ n̪ ɪ
висловлює	v ɪ s̪ l̪ ɔ v lʲ u ɛ
простих	p r ɔ s̪ t̪ ɪ x
випив	v ɪ p ɪ v
чарку	t̪ ʃ ɑ r k u
зацікавленість	z̪ ɑ t̪s̪ʲ i k ɑ v l̪ ɛ n̪ʲ i s̪ t̪
способу	s̪ p ɔ s̪ ɔ b u
забивати	z̪ ɑ b ɪ v ɑ t̪ ɪ
зразок	z̪ r ɑ z̪ ɔ k
комітету	k ɔ m i t̪ ɛ t̪ u
складний	s̪ k l̪ ɑ d̪ n̪ ɪ j
Всеукраїнської	v s̪ ɛ u k r ɑ j i n̪ s̪ k ɔ j i
асоціації	ɑ s̪ ɔ t̪s̪ʲ i ɑ t̪s̪ʲ i j i
ЖКГ	ʒ k ɦ
Луцька	l̪ u t̪s̪ʲ k ɑ
харківського	x ɑ r k i v s̪ k ɔ ɦ ɔ
Металіста	m ɛ t̪ ɑ lʲ i s̪ t̪ ɑ
сприяють	s̪ p r ɪ ɑ u t̪
вступив	v s̪ t̪ u p ɪ v
грав	ɦ r ɑ v
сусідньому	s̪ u s̪ i d̪ n̪ʲ ɔ m u
вигравала	v ɪ ɦ r ɑ v ɑ l̪ ɑ
лотерею	l̪ ɔ t̪ ɛ r ɛ u
бабуся	b ɑ b u s̪ ɑ
відзначив	v i d̪ z̪ n̪ ɑ t̪ ʃ ɪ v
Наразі	n̪ ɑ r ɑ z̪ʲ i
вокзали	v ɔ k z̪ ɑ l̪ ɪ
МКС	m k s̪
колекції	k ɔ l̪ ɛ k t̪s̪ʲ i j i
заодно	z̪ ɑ ɔ d̪ n̪ ɔ
посідали	p ɔ s̪ i d̪ ɑ l̪ ɪ
вербою	v ɛ r b ɔ u
Газпрому	ɦ ɑ z̪ p r ɔ m u
містечку	m i s̪ t̪ ɛ t̪ ʃ k u
останнє	ɔ s̪ t̪ ɑ n̪ n̪ʲ ɛ
пацієнтів	p ɑ t̪s̪ʲ i ɛ n̪ t̪ i v
констатував	k ɔ n̪ s̪ t̪ ɑ t̪ u v ɑ v
рекордні	r ɛ k ɔ r d̪ n̪ʲ i
овочі	ɔ v ɔ t̪ ʃ i
фрукти	f r u k t̪ ɪ
Юрія	j u rʲ i ɑ
позаганяв	p ɔ z̪ ɑ ɦ ɑ n̪ʲ ɑ v
загороду	z̪ ɑ ɦ ɔ r ɔ d̪ u
худобу	x u d̪ ɔ b u
закупівлі	z̪ ɑ k u p i v lʲ i
завищена	z̪ ɑ v ɪ ʃ t̪ ʃ ɛ n̪ ɑ
столітті	s̪ t̪ ɔ lʲ i t̪ t̪ i
харчування	x ɑ r t̪ ʃ u v ɑ n̪ n̪ʲ ɑ
покращення	p ɔ k r ɑ ʃ t̪ ʃ ɛ n̪ n̪ʲ ɑ
літаки	lʲ i t̪ ɑ k ɪ
глядачами	ɦ lʲ ɑ d̪ ɑ t̪ ʃ ɑ m ɪ
кіл	k i l̪
суда	s̪ u d̪ ɑ
стартував	s̪ t̪ ɑ r t̪ u v ɑ v
вдало	v d̪ ɑ l̪ ɔ
якомога	j ɑ k ɔ m ɔ ɦ ɑ
шахти	ʃ ɑ x t̪ ɪ
надійшла	n̪ ɑ d̪ʲ i j ʃ l̪ ɑ
з'явився	z̪ j ɑ v ɪ v s̪ ɑ
маєте	m ɑ ɛ t̪ ɛ
демократія	d̪ ɛ m ɔ k r ɑ t̪ i ɑ
забути	z̪ ɑ b u t̪ ɪ
невдачі	n̪ ɛ v d̪ ɑ t̪ ʃ i
вийдеш	v ɪ j d̪ ɛ ʃ
обіді	ɔ b i d̪ʲ i
основними	ɔ s̪ n̪ ɔ v n̪ ɪ m ɪ
поговорити	p ɔ ɦ ɔ v ɔ r ɪ t̪ ɪ
транспорту	t̪ r ɑ n̪ s̪ p ɔ r t̪ u
туризму	t̪ u r ɪ z̪ m u
футбольних	f u t̪ b ɔ lʲ n̪ ɪ x
прошу	p r ɔ ʃ u
активізувати	ɑ k t̪ ɪ v i z̪ u v ɑ t̪ ɪ
пристало	p r ɪ s̪ t̪ ɑ l̪ ɔ
дівчин	d̪ʲ i v t̪ ʃ ɪ n̪
етап	ɛ t̪ ɑ p
продукцію	p r ɔ d̪ u k t̪s̪ʲ i u
доти	d̪ ɔ t̪ ɪ
дошкулятиме	d̪ ɔ ʃ k u lʲ ɑ t̪ ɪ m ɛ
тінь	t̪ i n̪ʲ
радий	r ɑ d̪ ɪ j
Дню	d̪ n̪ʲ u
штабу	ʃ t̪ ɑ b u
зафіксували	z̪ ɑ f i k s̪ u v ɑ l̪ ɪ
систем	s̪ ɪ s̪ t̪ ɛ m
священика	s̪ v ɑ ʃ t̪ ʃ ɛ n̪ ɪ k ɑ
обіцяні	ɔ b i t̪s̪ʲ ɑ n̪ʲ i
податкові	p ɔ d̪ ɑ t̪ k ɔ v i
канікули	k ɑ n̪ʲ i k u l̪ ɪ
обернулися	ɔ b ɛ r n̪ u l̪ ɪ s̪ ɑ
податковим	p ɔ d̪ ɑ t̪ k ɔ v ɪ m
терором	t̪ ɛ r ɔ r ɔ m
наполегливим	n̪ ɑ p ɔ l̪ ɛ ɦ l̪ ɪ v ɪ m
намаганням	n̪ ɑ m ɑ ɦ ɑ n̪ n̪ʲ ɑ m
спрощену	s̪ p r ɔ ʃ t̪ ʃ ɛ n̪ u
чоловіком	t̪ ʃ ɔ l̪ ɔ v i k ɔ m
поспілкуватися	p ɔ s̪ p i l̪ k u v ɑ t̪ ɪ s̪ ɑ
райдержадміністрації	r ɑ j d̪ ɛ r ʒ ɑ d̪ m i n̪ʲ i s̪ t̪ r ɑ t̪s̪ʲ i j i
приклади	p r ɪ k l̪ ɑ d̪ ɪ
товариства	t̪ ɔ v ɑ r ɪ s̪ t̪ v ɑ
деякий	d̪ ɛ ɑ k ɪ j
Дніпропетровська	d̪ n̪ʲ i p r ɔ p ɛ t̪ r ɔ v s̪ k ɑ
вибігло	v ɪ b i ɦ l̪ ɔ
п'ятеро	p j ɑ t̪ ɛ r ɔ
невеличких	n̪ ɛ v ɛ l̪ ɪ t̪ ʃ k ɪ x
одержав	ɔ d̪ ɛ r ʒ ɑ v
народного	n̪ ɑ r ɔ d̪ n̪ ɔ ɦ ɔ
перш	p ɛ r ʃ
косив	k ɔ s̪ ɪ v
сіно	s̪ i n̪ ɔ
Чорноморський	t̪ ʃ ɔ r n̪ ɔ m ɔ r s̪ k ɪ j
флот	f l̪ ɔ t̪
нахопилася	n̪ ɑ x ɔ p ɪ l̪ ɑ s̪ ɑ
зза	z̪ z̪ ɑ
тремтить	t̪ r ɛ m t̪ ɪ t̪
переливається	p ɛ r ɛ l̪ ɪ v ɑ ɛ t̪ s̪ ɑ
застигає	z̪ ɑ s̪ t̪ ɪ ɦ ɑ ɛ
повітрі	p ɔ v i t̪ rʲ i
розпізнавати	r ɔ z̪ p i z̪ n̪ ɑ v ɑ t̪ ɪ
продиктовані	p r ɔ d̪ ɪ k t̪ ɔ v ɑ n̪ʲ i
речення	r ɛ t̪ ʃ ɛ n̪ n̪ʲ ɑ
донести	d̪ ɔ n̪ ɛ s̪ t̪ ɪ
темні	t̪ ɛ m n̪ʲ i
карі	k ɑ rʲ i
гострі	ɦ ɔ s̪ t̪ rʲ i
книжку	k n̪ ɪ ʒ k u
написав	n̪ ɑ p ɪ s̪ ɑ v
проголосували	p r ɔ ɦ ɔ l̪ ɔ s̪ u v ɑ l̪ ɪ
організували	ɔ r ɦ ɑ n̪ʲ i z̪ u v ɑ l̪ ɪ
сприймати	s̪ p r ɪ j m ɑ t̪ ɪ
виду	v ɪ d̪ u
воді	v ɔ d̪ʲ i
випуск	v ɪ p u s̪ k
підозрою	p i d̪ ɔ z̪ r ɔ u
навесні	n̪ ɑ v ɛ s̪ n̪ʲ i
Кировограді	k ɪ r ɔ v ɔ ɦ r ɑ d̪ʲ i
п'ятнадцята	p j ɑ t̪ n̪ ɑ d̪ t̪s̪ʲ ɑ t̪ ɑ
бажаєш	b ɑ ʒ ɑ ɛ ʃ
директора	d̪ ɪ r ɛ k t̪ ɔ r ɑ
ходив	x ɔ d̪ ɪ v
матимуть	m ɑ t̪ ɪ m u t̪
власники	v l̪ ɑ s̪ n̪ ɪ k ɪ
матеріал	m ɑ t̪ ɛ rʲ i ɑ l̪
тривалість	t̪ r ɪ v ɑ lʲ i s̪ t̪
Землі	z̪ ɛ m lʲ i
Феодосії	f ɛ ɔ d̪ ɔ s̪ i j i
формує	f ɔ r m u ɛ
чотирнадцяте	t̪ ʃ ɔ t̪ ɪ r n̪ ɑ d̪ t̪s̪ʲ ɑ t̪ ɛ
Франкфурті	f r ɑ n̪ k f u r t̪ i
сучасна	s̪ u t̪ ʃ ɑ s̪ n̪ ɑ
нація	n̪ ɑ t̪s̪ʲ i ɑ
компенсації	k ɔ m p ɛ n̪ s̪ ɑ t̪s̪ʲ i j i
шило	ʃ ɪ l̪ ɔ
партнери	p ɑ r t̪ n̪ ɛ r ɪ
журі	ʒ u rʲ i
Російської	r ɔ s̪ i j s̪ k ɔ j i
підприємстві	p i d̪ p r ɪ ɛ m s̪ t̪ v i
виділено	v ɪ d̪ʲ i l̪ ɛ n̪ ɔ
Гаянна	ɦ ɑ ɑ n̪ n̪ ɑ
закінчила	z̪ ɑ k i n̪ t̪ ʃ ɪ l̪ ɑ
Фонд	f ɔ n̪ d̪
держмайна	d̪ ɛ r ʒ m ɑ j n̪ ɑ
ухвалив	u x v ɑ l̪ ɪ v
обговорювали	ɔ b ɦ ɔ v ɔ rʲ u v ɑ l̪ ɪ
перебіг	p ɛ r ɛ b i ɦ
естафету	ɛ s̪ t̪ ɑ f ɛ t̪ u
Спартак	s̪ p ɑ r t̪ ɑ k
націлився	n̪ ɑ t̪s̪ʲ i l̪ ɪ v s̪ ɑ
захисника	z̪ ɑ x ɪ s̪ n̪ ɪ k ɑ
Евертона	ɛ v ɛ r t̪ ɔ n̪ ɑ
сірому	s̪ i r ɔ m u
камені	k ɑ m ɛ n̪ʲ i
плавиться	p l̪ ɑ v ɪ t̪ s̪ ɑ
Європейський	j ɛ v r ɔ p ɛ j s̪ k ɪ j
сучасний	s̪ u t̪ ʃ ɑ s̪ n̪ ɪ j
свідомість	s̪ v i d̪ ɔ m i s̪ t̪
мільярда	m i lʲ ɑ r d̪ ɑ
ухвалила	u x v ɑ l̪ ɪ l̪ ɑ
сесія	s̪ ɛ s̪ i ɑ
мітинг	m i t̪ ɪ n̪ ɦ
продасть	p r ɔ d̪ ɑ s̪ t̪
ГТС	ɦ t̪ s̪
наполягає	n̪ ɑ p ɔ lʲ ɑ ɦ ɑ ɛ
перемагають	p ɛ r ɛ m ɑ ɦ ɑ u t̪
німці	n̪ʲ i m t̪s̪ʲ i
правоохоронних	p r ɑ v ɔ ɔ x ɔ r ɔ n̪ n̪ ɪ x
показав	p ɔ k ɑ z̪ ɑ v
економічної	ɛ k ɔ n̪ ɔ m i t̪ ʃ n̪ ɔ j i
твір	t̪ v i r
перекладач	p ɛ r ɛ k l̪ ɑ d̪ ɑ t̪ ʃ
образ	ɔ b r ɑ z̪
Європейської	j ɛ v r ɔ p ɛ j s̪ k ɔ j i
ЛІГАБізнесІнформ	lʲ i ɦ ɑ b i z̪ n̪ ɛ s̪ i n̪ f ɔ r m
Явдоха	j ɑ v d̪ ɔ x ɑ
Ой	ɔ j
тяжко	t̪ ɑ ʒ k ɔ
зітхала	z̪ʲ i t̪ x ɑ l̪ ɑ
гризня	ɦ r ɪ z̪ n̪ʲ ɑ
лайка	l̪ ɑ j k ɑ
щоденна	ʃ t̪ ʃ ɔ d̪ ɛ n̪ n̪ ɑ
наробив	n̪ ɑ r ɔ b ɪ v
нараховується	n̪ ɑ r ɑ x ɔ v u ɛ t̪ s̪ ɑ
викладачів	v ɪ k l̪ ɑ d̪ ɑ t̪ ʃ i v
Поліція	p ɔ lʲ i t̪s̪ʲ i ɑ
пекло	p ɛ k l̪ ɔ
приязно	p r ɪ ɑ z̪ n̪ ɔ
сяло	s̪ ɑ l̪ ɔ
гріло	ɦ rʲ i l̪ ɔ
вашій	v ɑ ʃ i j
фактів	f ɑ k t̪ i v
теракту	t̪ ɛ r ɑ k t̪ u
Кабінет	k ɑ b i n̪ ɛ t̪
дозволив	d̪ ɔ z̪ v ɔ l̪ ɪ v
концесію	k ɔ n̪ t̪s̪ ɛ s̪ i u
кличуть	k l̪ ɪ t̪ ʃ u t̪
пашпорт	p ɑ ʃ p ɔ r t̪
наказом	n̪ ɑ k ɑ z̪ ɔ m
отримають	ɔ t̪ r ɪ m ɑ u t̪
вподобала	v p ɔ d̪ ɔ b ɑ l̪ ɑ
влітку	v lʲ i t̪ k u
обирати	ɔ b ɪ r ɑ t̪ ɪ
суддів	s̪ u d̪ d̪ʲ i v
додала	d̪ ɔ d̪ ɑ l̪ ɑ
журливо	ʒ u r l̪ ɪ v ɔ
скривилася	s̪ k r ɪ v ɪ l̪ ɑ s̪ ɑ
Обама	ɔ b ɑ m ɑ
компроміс	k ɔ m p r ɔ m i s̪
обидва	ɔ b ɪ d̪ v ɑ
літо	lʲ i t̪ ɔ
втратиш	v t̪ r ɑ t̪ ɪ ʃ
одними	ɔ d̪ n̪ ɪ m ɪ
зароблю	z̪ ɑ r ɔ b lʲ u
Галя	ɦ ɑ lʲ ɑ
розум	r ɔ z̪ u m
покинув	p ɔ k ɪ n̪ u v
дворі	d̪ v ɔ rʲ i
дванадцятий	d̪ v ɑ n̪ ɑ d̪ t̪s̪ʲ ɑ t̪ ɪ j
порадився	p ɔ r ɑ d̪ ɪ v s̪ ɑ
тещею	t̪ ɛ ʃ t̪ ʃ ɛ u
випила	v ɪ p ɪ l̪ ɑ
кров	k r ɔ v
п'яною	p j ɑ n̪ ɔ u
договору	d̪ ɔ ɦ ɔ v ɔ r u
захворювання	z̪ ɑ x v ɔ rʲ u v ɑ n̪ n̪ʲ ɑ
можливостей	m ɔ ʒ l̪ ɪ v ɔ s̪ t̪ ɛ j
постікали	p ɔ s̪ t̪ i k ɑ l̪ ɪ
зазеленіли	z̪ ɑ z̪ ɛ l̪ ɛ n̪ʲ i l̪ ɪ
трави	t̪ r ɑ v ɪ
зацвіли	z̪ ɑ t̪s̪ v i l̪ ɪ
садки	s̪ ɑ d̪ k ɪ
городи	ɦ ɔ r ɔ d̪ ɪ
контролем	k ɔ n̪ t̪ r ɔ l̪ ɛ m
декларації	d̪ ɛ k l̪ ɑ r ɑ t̪s̪ʲ i j i
податковий	p ɔ d̪ ɑ t̪ k ɔ v ɪ j
наступному	n̪ ɑ s̪ t̪ u p n̪ ɔ m u
з'являються	z̪ j ɑ v lʲ ɑ u t̪ s̪ ɑ
матеріали	m ɑ t̪ ɛ rʲ i ɑ l̪ ɪ
чудно	t̪ ʃ u d̪ n̪ ɔ
дивилась	d̪ ɪ v ɪ l̪ ɑ s̪
мутними	m u t̪ n̪ ɪ m ɪ
схилила	s̪ x ɪ l̪ ɪ l̪ ɑ
духу	d̪ u x u
голоду	ɦ ɔ l̪ ɔ d̪ u
віру	v i r u
автора	ɑ v t̪ ɔ r ɑ
взялася	v z̪ʲ ɑ l̪ ɑ s̪ ɑ
призначив	p r ɪ z̪ n̪ ɑ t̪ ʃ ɪ v
главу	ɦ l̪ ɑ v u
мірі	m i rʲ i
бюджетні	b u d̪ ʒ ɛ t̪ n̪ʲ i
контролю	k ɔ n̪ t̪ r ɔ lʲ u
підлягають	p i d̪ lʲ ɑ ɦ ɑ u t̪
Правоохоронці	p r ɑ v ɔ ɔ x ɔ r ɔ n̪ t̪s̪ʲ i
об'єктів	ɔ b j ɛ k t̪ i v
автомобіль	ɑ v t̪ ɔ m ɔ b i lʲ
Кіровограді	k i r ɔ v ɔ ɦ r ɑ d̪ʲ i
вигукує	v ɪ ɦ u k u ɛ
траншу	t̪ r ɑ n̪ ʃ u
становив	s̪ t̪ ɑ n̪ ɔ v ɪ v
другому	d̪ r u ɦ ɔ m u
гаряча	ɦ ɑ rʲ ɑ t̪ ʃ ɑ
кандидата	k ɑ n̪ d̪ ɪ d̪ ɑ t̪ ɑ
атакувальний	ɑ t̪ ɑ k u v ɑ lʲ n̪ ɪ j
півзахисник	p i v z̪ ɑ x ɪ s̪ n̪ ɪ k
Карпат	k ɑ r p ɑ t̪
перейде	p ɛ r ɛ j d̪ ɛ
діяльності	d̪ʲ i ɑ lʲ n̪ ɔ s̪ t̪ i
запровадження	z̪ ɑ p r ɔ v ɑ d̪ ʒ ɛ n̪ n̪ʲ ɑ
пенсійної	p ɛ n̪ s̪ i j n̪ ɔ j i
блок	b l̪ ɔ k
прес–службі	p r ɛ s̪ s̪ l̪ u ʒ b i
нинішньому	n̪ ɪ n̪ʲ i ʃ n̪ʲ ɔ m u
унікальні	u n̪ʲ i k ɑ lʲ n̪ʲ i
стомлено	s̪ t̪ ɔ m l̪ ɛ n̪ ɔ
зітхнули	z̪ʲ i t̪ x n̪ u l̪ ɪ
замовкнули	z̪ ɑ m ɔ v k n̪ u l̪ ɪ
генерал	ɦ ɛ n̪ ɛ r ɑ l̪
пильно	p ɪ lʲ n̪ ɔ
Мирона	m ɪ r ɔ n̪ ɑ
політиці	p ɔ lʲ i t̪ ɪ t̪s̪ʲ i
принцип	p r ɪ n̪ t̪s̪ ɪ p
братів	b r ɑ t̪ i v
пору	p ɔ r u
адміністрування	ɑ d̪ m i n̪ʲ i s̪ t̪ r u v ɑ n̪ n̪ʲ ɑ
короткий	k ɔ r ɔ t̪ k ɪ j
зростають	z̪ r ɔ s̪ t̪ ɑ u t̪
прибутки	p r ɪ b u t̪ k ɪ
спільний	s̪ p i lʲ n̪ ɪ j
пошук	p ɔ ʃ u k
розв'язання	r ɔ z̪ v j ɑ z̪ ɑ n̪ n̪ʲ ɑ
підійде	p i d̪ʲ i j d̪ ɛ
коштом	k ɔ ʃ t̪ ɔ m
страхового	s̪ t̪ r ɑ x ɔ v ɔ ɦ ɔ
безробіття	b ɛ z̪ r ɔ b i t̪ t̪ ɑ
минулий	m ɪ n̪ u l̪ ɪ j
присівши	p r ɪ s̪ i v ʃ ɪ
розповідати	r ɔ z̪ p ɔ v i d̪ ɑ t̪ ɪ
справжньої	s̪ p r ɑ v ʒ n̪ʲ ɔ j i
Героя	ɦ ɛ r ɔ ɑ
ждати	ʒ d̪ ɑ t̪ ɪ
військової	v i j s̪ k ɔ v ɔ j i
Київського	k ɪ j i v s̪ k ɔ ɦ ɔ
останню	ɔ s̪ t̪ ɑ n̪ n̪ʲ u
розпродаж	r ɔ z̪ p r ɔ d̪ ɑ ʒ
тридцятого	t̪ r ɪ d̪ t̪s̪ʲ ɑ t̪ ɔ ɦ ɔ
решту	r ɛ ʃ t̪ u
коментуючи	k ɔ m ɛ n̪ t̪ u u t̪ ʃ ɪ
аеропорту	ɑ ɛ r ɔ p ɔ r t̪ u
Колесніков	k ɔ l̪ ɛ s̪ n̪ʲ i k ɔ v
Миколаїві	m ɪ k ɔ l̪ ɑ j i v i
державності	d̪ ɛ r ʒ ɑ v n̪ ɔ s̪ t̪ i
претендентів	p r ɛ t̪ ɛ n̪ d̪ ɛ n̪ t̪ i v
довгообразе	d̪ ɔ v ɦ ɔ ɔ b r ɑ z̪ ɛ
козаче	k ɔ z̪ ɑ t̪ ʃ ɛ
військового	v i j s̪ k ɔ v ɔ ɦ ɔ
новому	n̪ ɔ v ɔ m u
витягнув	v ɪ t̪ ɑ ɦ n̪ u v
гамана	ɦ ɑ m ɑ n̪ ɑ
шматок	ʃ m ɑ t̪ ɔ k
засмальцьованого	z̪ ɑ s̪ m ɑ lʲ t̪s̪ʲ ɔ v ɑ n̪ ɔ ɦ ɔ
паперу	p ɑ p ɛ r u
дід	d̪ʲ i d̪
старий	s̪ t̪ ɑ r ɪ j
бородою	b ɔ r ɔ d̪ ɔ u
Полтавської	p ɔ l̪ t̪ ɑ v s̪ k ɔ j i
битви	b ɪ t̪ v ɪ
розпізнавач	r ɔ z̪ p i z̪ n̪ ɑ v ɑ t̪ ʃ
укаїнської	u k ɑ j i n̪ s̪ k ɔ j i
гарно	ɦ ɑ r n̪ ɔ
любо	lʲ u b ɔ
справжні	s̪ p r ɑ v ʒ n̪ʲ i
журналіст	ʒ u r n̪ ɑ lʲ i s̪ t̪
прийому	p r ɪ j ɔ m u
косар	k ɔ s̪ ɑ r
жвавий	ʒ v ɑ v ɪ j
невтомний	n̪ ɛ v t̪ ɔ m n̪ ɪ j
громадськість	ɦ r ɔ m ɑ d̪ s̪ k i s̪ t̪
Євросоюзу	j ɛ v r ɔ s̪ ɔ u z̪ u
Сталіна	s̪ t̪ ɑ lʲ i n̪ ɑ
голосно	ɦ ɔ l̪ ɔ s̪ n̪ ɔ
кричало	k r ɪ t̪ ʃ ɑ l̪ ɔ
бабів	b ɑ b i v
Японія	j ɑ p ɔ n̪ʲ i ɑ
сліди	s̪ lʲ i d̪ ɪ
красиві	k r ɑ s̪ ɪ v i
прямо	p rʲ ɑ m ɔ
протилежні	p r ɔ t̪ ɪ l̪ ɛ ʒ n̪ʲ i
мільйон	m i lʲ j ɔ n̪
усіма	u s̪ i m ɑ
Кучмі	k u t̪ ʃ m i
усвідомлення	u s̪ v i d̪ ɔ m l̪ ɛ n̪ n̪ʲ ɑ
чотирнадцята	t̪ ʃ ɔ t̪ ɪ r n̪ ɑ d̪ t̪s̪ʲ ɑ t̪ ɑ
звилини	z̪ v ɪ l̪ ɪ n̪ ɪ
модель	m ɔ d̪ ɛ lʲ
перспектива	p ɛ r s̪ p ɛ k t̪ ɪ v ɑ
членства	t̪ ʃ l̪ ɛ n̪ s̪ t̪ v ɑ
закріплена	z̪ ɑ k rʲ i p l̪ ɛ n̪ ɑ
колеги	k ɔ l̪ ɛ ɦ ɪ
здійснення	z̪ d̪ʲ i j s̪ n̪ ɛ n̪ n̪ʲ ɑ
серця	s̪ ɛ r t̪s̪ʲ ɑ
вдосконалення	v d̪ ɔ s̪ k ɔ n̪ ɑ l̪ ɛ n̪ n̪ʲ ɑ
стара	s̪ t̪ ɑ r ɑ
здуріла	z̪ d̪ u rʲ i l̪ ɑ
старість	s̪ t̪ ɑ rʲ i s̪ t̪
Кубку	k u b k u
донеччани	d̪ ɔ n̪ ɛ t̪ ʃ t̪ ʃ ɑ n̪ ɪ
стартували	s̪ t̪ ɑ r t̪ u v ɑ l̪ ɪ
пам'ять	p ɑ m j ɑ t̪
власних	v l̪ ɑ s̪ n̪ ɪ x
скарби	s̪ k ɑ r b ɪ
якоїсь	j ɑ k ɔ j i s̪
уважно	u v ɑ ʒ n̪ ɔ
Сталін	s̪ t̪ ɑ lʲ i n̪
нокаутував	n̪ ɔ k ɑ u t̪ u v ɑ v
Повєткіна	p ɔ v ɛ t̪ k i n̪ ɑ
хотіти	x ɔ t̪ i t̪ ɪ
Конотоп	k ɔ n̪ ɔ t̪ ɔ p
залишаюся	z̪ ɑ l̪ ɪ ʃ ɑ u s̪ ɑ
українцем	u k r ɑ j i n̪ t̪s̪ ɛ m
наступних	n̪ ɑ s̪ t̪ u p n̪ ɪ x
такій	t̪ ɑ k i j
необхідність	n̪ ɛ ɔ b x i d̪ n̪ʲ i s̪ t̪
реформ	r ɛ f ɔ r m
думає	d̪ u m ɑ ɛ
хутко	x u t̪ k ɔ
погнав	p ɔ ɦ n̪ ɑ v
вернувся	v ɛ r n̪ u v s̪ ɑ
швиденько	ʃ v ɪ d̪ ɛ n̪ʲ k ɔ
зачинив	z̪ ɑ t̪ ʃ ɪ n̪ ɪ v
подібний	p ɔ d̪ʲ i b n̪ ɪ j
заклад	z̪ ɑ k l̪ ɑ d̪
карбованців	k ɑ r b ɔ v ɑ n̪ t̪s̪ʲ i v
потрапити	p ɔ t̪ r ɑ p ɪ t̪ ɪ
компромісу	k ɔ m p r ɔ m i s̪ u
ядерної	j ɑ d̪ ɛ r n̪ ɔ j i
холеру	x ɔ l̪ ɛ r u
загороди	z̪ ɑ ɦ ɔ r ɔ d̪ ɪ
дивізіоні	d̪ ɪ v i z̪ʲ i ɔ n̪ʲ i
боксерів	b ɔ k s̪ ɛ rʲ i v
битися	b ɪ t̪ ɪ s̪ ɑ
дереву	d̪ ɛ r ɛ v u
отже	ɔ t̪ ʒ ɛ
протидії	p r ɔ t̪ ɪ d̪ʲ i j i
господар	ɦ ɔ s̪ p ɔ d̪ ɑ r
книгу	k n̪ ɪ ɦ u
послали	p ɔ s̪ l̪ ɑ l̪ ɪ
Дубина	d̪ u b ɪ n̪ ɑ
зарплат	z̪ ɑ r p l̪ ɑ t̪
скочив	s̪ k ɔ t̪ ʃ ɪ v
Мішель	m i ʃ ɛ lʲ
Платіні	p l̪ ɑ t̪ i n̪ʲ i
влаштував	v l̪ ɑ ʃ t̪ u v ɑ v
бійку	b i j k u
виконавчої	v ɪ k ɔ n̪ ɑ v t̪ ʃ ɔ j i
законодавчої	z̪ ɑ k ɔ n̪ ɔ d̪ ɑ v t̪ ʃ ɔ j i
моїм	m ɔ j i m
Острозький	ɔ s̪ t̪ r ɔ z̪ʲ k ɪ j
Ісінбаєва	i s̪ i n̪ b ɑ ɛ v ɑ
встановила	v s̪ t̪ ɑ n̪ ɔ v ɪ l̪ ɑ
втрьох	v t̪ rʲ ɔ x
заразтаки	z̪ ɑ r ɑ z̪ t̪ ɑ k ɪ
тринадцяте	t̪ r ɪ n̪ ɑ d̪ t̪s̪ʲ ɑ t̪ ɛ
національних	n̪ ɑ t̪s̪ʲ i ɔ n̪ ɑ lʲ n̪ ɪ x
перспектив	p ɛ r s̪ p ɛ k t̪ ɪ v
заяв	z̪ ɑ ɑ v
очикуємо	ɔ t̪ ʃ ɪ k u ɛ m ɔ
президентської	p r ɛ z̪ ɪ d̪ ɛ n̪ t̪ s̪ k ɔ j i
Льовочкін	lʲ ɔ v ɔ t̪ ʃ k i n̪
відомим	v i d̪ ɔ m ɪ m
моря	m ɔ rʲ ɑ
організм	ɔ r ɦ ɑ n̪ʲ i z̪ m
Рахункової	r ɑ x u n̪ k ɔ v ɔ j i
палати	p ɑ l̪ ɑ t̪ ɪ
цікава	t̪s̪ʲ i k ɑ v ɑ
сестри	s̪ ɛ s̪ t̪ r ɪ
скоро	s̪ k ɔ r ɔ
сприймає	s̪ p r ɪ j m ɑ ɛ
отаманує	ɔ t̪ ɑ m ɑ n̪ u ɛ
використовується	v ɪ k ɔ r ɪ s̪ t̪ ɔ v u ɛ t̪ s̪ ɑ
Міллер	m i l̪ l̪ ɛ r
перебігав	p ɛ r ɛ b i ɦ ɑ v
нивки	n̪ ɪ v k ɪ
нивку	n̪ ɪ v k u
живить	ʒ ɪ v ɪ t̪
освіжав	ɔ s̪ v i ʒ ɑ v
кожну	k ɔ ʒ n̪ u
билинку	b ɪ l̪ ɪ n̪ k u
допомогли	d̪ ɔ p ɔ m ɔ ɦ l̪ ɪ
Велика	v ɛ l̪ ɪ k ɑ
розбіжимося	r ɔ z̪ b i ʒ ɪ m ɔ s̪ ɑ
сією	s̪ i ɛ u
улицею	u l̪ ɪ t̪s̪ ɛ u
малося	m ɑ l̪ ɔ s̪ ɑ
вусам	v u s̪ ɑ m
читачам	t̪ ʃ ɪ t̪ ɑ t̪ ʃ ɑ m
виявився	v ɪ ɑ v ɪ v s̪ ɑ
рідних	rʲ i d̪ n̪ ɪ x
знаходилися	z̪ n̪ ɑ x ɔ d̪ ɪ l̪ ɪ s̪ ɑ
теплохода	t̪ ɛ p l̪ ɔ x ɔ d̪ ɑ
дума	d̪ u m ɑ
залучити	z̪ ɑ l̪ u t̪ ʃ ɪ t̪ ɪ
обладнання	ɔ b l̪ ɑ d̪ n̪ ɑ n̪ n̪ʲ ɑ
відчувається	v i d̪ t̪ ʃ u v ɑ ɛ t̪ s̪ ɑ
хлопчики	x l̪ ɔ p t̪ ʃ ɪ k ɪ
старшенькому	s̪ t̪ ɑ r ʃ ɛ n̪ʲ k ɔ m u
меншому	m ɛ n̪ ʃ ɔ m u
мазанок	m ɑ z̪ ɑ n̪ ɔ k
хат	x ɑ t̪
розмір	r ɔ z̪ m i r
тримали	t̪ r ɪ m ɑ l̪ ɪ
чорних	t̪ ʃ ɔ r n̪ ɪ x
Економічній	ɛ k ɔ n̪ ɔ m i t̪ ʃ n̪ʲ i j
додатково	d̪ ɔ d̪ ɑ t̪ k ɔ v ɔ
втрат	v t̪ r ɑ t̪
мита	m ɪ t̪ ɑ
Мюнхені	m u n̪ x ɛ n̪ʲ i
правий	p r ɑ v ɪ j
Барси	b ɑ r s̪ ɪ
Мілан	m i l̪ ɑ n̪
єдність	j ɛ d̪ n̪ʲ i s̪ t̪
цікавий	t̪s̪ʲ i k ɑ v ɪ j
зробимо	z̪ r ɔ b ɪ m ɔ
гриву	ɦ r ɪ v u
завели	z̪ ɑ v ɛ l̪ ɪ
хлів	x lʲ i v
заперли	z̪ ɑ p ɛ r l̪ ɪ
активи	ɑ k t̪ ɪ v ɪ
зменшення	z̪ m ɛ n̪ ʃ ɛ n̪ n̪ʲ ɑ
висловили	v ɪ s̪ l̪ ɔ v ɪ l̪ ɪ
внутрішнього	v n̪ u t̪ rʲ i ʃ n̪ʲ ɔ ɦ ɔ
квартал	k v ɑ r t̪ ɑ l̪
тримає	t̪ r ɪ m ɑ ɛ
китайській	k ɪ t̪ ɑ j s̪ k i j
ієрогліф	i ɛ r ɔ ɦ lʲ i f
Мирін	m ɪ rʲ i n̪
чогось	t̪ ʃ ɔ ɦ ɔ s̪
понуро	p ɔ n̪ u r ɔ
Польщу	p ɔ lʲ ʃ t̪ ʃ u
пенсію	p ɛ n̪ s̪ i u
валюта	v ɑ lʲ u t̪ ɑ
снаги	s̪ n̪ ɑ ɦ ɪ
фіналу	f i n̪ ɑ l̪ u
здійснив	z̪ d̪ʲ i j s̪ n̪ ɪ v
молодій	m ɔ l̪ ɔ d̪ʲ i j
знаходиться	z̪ n̪ ɑ x ɔ d̪ ɪ t̪ s̪ ɑ
подружжя	p ɔ d̪ r u ʒ ʒ ɑ
помітно	p ɔ m i t̪ n̪ ɔ
іспанці	i s̪ p ɑ n̪ t̪s̪ʲ i
допустить	d̪ ɔ p u s̪ t̪ ɪ t̪
чудові	t̪ ʃ u d̪ ɔ v i
тисне	t̪ ɪ s̪ n̪ ɛ
грошима	ɦ r ɔ ʃ ɪ m ɑ
ознаки	ɔ z̪ n̪ ɑ k ɪ
пройшла	p r ɔ j ʃ l̪ ɑ
приймають	p r ɪ j m ɑ u t̪
духовного	d̪ u x ɔ v n̪ ɔ ɦ ɔ
критично	k r ɪ t̪ ɪ t̪ ʃ n̪ ɔ
відпусти	v i d̪ p u s̪ t̪ ɪ
благаю	b l̪ ɑ ɦ ɑ u
звані	z̪ v ɑ n̪ʲ i
виступають	v ɪ s̪ t̪ u p ɑ u t̪
Грицько	ɦ r ɪ t̪s̪ʲ k ɔ
побачивши	p ɔ b ɑ t̪ ʃ ɪ v ʃ ɪ
сумного	s̪ u m n̪ ɔ ɦ ɔ
обізвався	ɔ b i z̪ v ɑ v s̪ ɑ
набрав	n̪ ɑ b r ɑ v
відставки	v i d̪ s̪ t̪ ɑ v k ɪ
четвертого	t̪ ʃ ɛ t̪ v ɛ r t̪ ɔ ɦ ɔ
дефолту	d̪ ɛ f ɔ l̪ t̪ u
найбільшим	n̪ ɑ j b i lʲ ʃ ɪ m
Арсеній	ɑ r s̪ ɛ n̪ʲ i j
панів	p ɑ n̪ʲ i v
зростати	z̪ r ɔ s̪ t̪ ɑ t̪ ɪ
імпорт	i m p ɔ r t̪
сьогоднішній	s̪ ɔ ɦ ɔ d̪ n̪ʲ i ʃ n̪ʲ i j
становитиме	s̪ t̪ ɑ n̪ ɔ v ɪ t̪ ɪ m ɛ
мільярди	m i lʲ ɑ r d̪ ɪ
особу	ɔ s̪ ɔ b u
вступ	v s̪ t̪ u p
ходять	x ɔ d̪ʲ ɑ t̪
зазимую	z̪ ɑ z̪ ɪ m u u
остогидло	ɔ s̪ t̪ ɔ ɦ ɪ d̪ l̪ ɔ
розбирався	r ɔ z̪ b ɪ r ɑ v s̪ ɑ
програмуванні	p r ɔ ɦ r ɑ m u v ɑ n̪ n̪ʲ i
ухом	u x ɔ m
вбивство	v b ɪ v s̪ t̪ v ɔ
пускаєш	p u s̪ k ɑ ɛ ʃ
відсутності	v i d̪ s̪ u t̪ n̪ ɔ s̪ t̪ i
товариством	t̪ ɔ v ɑ r ɪ s̪ t̪ v ɔ m
альбом	ɑ lʲ b ɔ m
моєму	m ɔ ɛ m u
виконанні	v ɪ k ɔ n̪ ɑ n̪ n̪ʲ i
відвідав	v i d̪ v i d̪ ɑ v
Євросоюз	j ɛ v r ɔ s̪ ɔ u z̪
замку	z̪ ɑ m k u
сусідньої	s̪ u s̪ i d̪ n̪ʲ ɔ j i
Центральної	t̪s̪ ɛ n̪ t̪ r ɑ lʲ n̪ ɔ j i
Європою	j ɛ v r ɔ p ɔ u
чиновника	t̪ ʃ ɪ n̪ ɔ v n̪ ɪ k ɑ
іграх	i ɦ r ɑ x
поразок	p ɔ r ɑ z̪ ɔ k
судом	s̪ u d̪ ɔ m
догадалася	d̪ ɔ ɦ ɑ d̪ ɑ l̪ ɑ s̪ ɑ
захожому	z̪ ɑ x ɔ ʒ ɔ m u
здався	z̪ d̪ ɑ v s̪ ɑ
ударів	u d̪ ɑ rʲ i v
воротах	v ɔ r ɔ t̪ ɑ x
кореспонденту	k ɔ r ɛ s̪ p ɔ n̪ d̪ ɛ n̪ t̪ u
спасибі	s̪ p ɑ s̪ ɪ b i
Богові	b ɔ ɦ ɔ v i
криза	k r ɪ z̪ ɑ
пов'язані	p ɔ v j ɑ z̪ ɑ n̪ʲ i
зацікавлений	z̪ ɑ t̪s̪ʲ i k ɑ v l̪ ɛ n̪ ɪ j
довкруж	d̪ ɔ v k r u ʒ
гірників	ɦ i r n̪ ɪ k i v
живо	ʒ ɪ v ɔ
цівавився	t̪s̪ʲ i v ɑ v ɪ v s̪ ɑ
математикою	m ɑ t̪ ɛ m ɑ t̪ ɪ k ɔ u
фізикою	f i z̪ ɪ k ɔ u
хімію	x i m i u
зареєстровано	z̪ ɑ r ɛ ɛ s̪ t̪ r ɔ v ɑ n̪ ɔ
гривні	ɦ r ɪ v n̪ʲ i
долара	d̪ ɔ l̪ ɑ r ɑ
значних	z̪ n̪ ɑ t̪ ʃ n̪ ɪ x
повозки	p ɔ v ɔ z̪ k ɪ
вискочив	v ɪ s̪ k ɔ t̪ ʃ ɪ v
генералові	ɦ ɛ n̪ ɛ r ɑ l̪ ɔ v i
привернути	p r ɪ v ɛ r n̪ u t̪ ɪ
заявили	z̪ ɑ ɑ v ɪ l̪ ɪ
підперта	p i d̪ p ɛ r t̪ ɑ
стовпами	s̪ t̪ ɔ v p ɑ m ɪ
унікальний	u n̪ʲ i k ɑ lʲ n̪ ɪ j
лівий	lʲ i v ɪ j
захисник	z̪ ɑ x ɪ s̪ n̪ ɪ k
Реала	r ɛ ɑ l̪ ɑ
Ман	m ɑ n̪
Сіті	s̪ i t̪ i
опинилися	ɔ p ɪ n̪ ɪ l̪ ɪ s̪ ɑ
провалено	p r ɔ v ɑ l̪ ɛ n̪ ɔ
Штуттгарті	ʃ t̪ u t̪ t̪ ɦ ɑ r t̪ i
розпорядженні	r ɔ z̪ p ɔ rʲ ɑ d̪ ʒ ɛ n̪ n̪ʲ i
коментувати	k ɔ m ɛ n̪ t̪ u v ɑ t̪ ɪ
шостий	ʃ ɔ s̪ t̪ ɪ j
загаявся	z̪ ɑ ɦ ɑ ɑ v s̪ ɑ
судячи	s̪ u d̪ʲ ɑ t̪ ʃ ɪ
житлових	ʒ ɪ t̪ l̪ ɔ v ɪ x
дивимось	d̪ ɪ v ɪ m ɔ s̪
дванадцятій	d̪ v ɑ n̪ ɑ d̪ t̪s̪ʲ ɑ t̪ i j
віра	v i r ɑ
черзі	t̪ ʃ ɛ r z̪ʲ i
здійснити	z̪ d̪ʲ i j s̪ n̪ ɪ t̪ ɪ
морем	m ɔ r ɛ m
коти	k ɔ t̪ ɪ
всюди	v s̪ u d̪ ɪ
приймали	p r ɪ j m ɑ l̪ ɪ
осінь	ɔ s̪ i n̪ʲ
ніс	n̪ʲ i s̪
невеличкий	n̪ ɛ v ɛ l̪ ɪ t̪ ʃ k ɪ j
тонкий	t̪ ɔ n̪ k ɪ j
загострений	z̪ ɑ ɦ ɔ s̪ t̪ r ɛ n̪ ɪ j
сходу	s̪ x ɔ d̪ u
бродягу	b r ɔ d̪ʲ ɑ ɦ u
тюрму	t̪ u r m u
запруть	z̪ ɑ p r u t̪
поставила	p ɔ s̪ t̪ ɑ v ɪ l̪ ɑ
Загальний	z̪ ɑ ɦ ɑ lʲ n̪ ɪ j
оцінюється	ɔ t̪s̪ʲ i n̪ʲ u ɛ t̪ s̪ ɑ
мільярдів	m i lʲ ɑ r d̪ʲ i v
прогноз	p r ɔ ɦ n̪ ɔ z̪
об'явлено	ɔ b j ɑ v l̪ ɛ n̪ ɔ
дзвінко	d̪ z̪ v i n̪ k ɔ
кричить	k r ɪ t̪ ʃ ɪ t̪
смітниках	s̪ m i t̪ n̪ ɪ k ɑ x
дітвора	d̪ʲ i t̪ v ɔ r ɑ
тиху	t̪ ɪ x u
таємну	t̪ ɑ ɛ m n̪ u
мислення	m ɪ s̪ l̪ ɛ n̪ n̪ʲ ɑ
РФ	r f
крапку	k r ɑ p k u
заплатити	z̪ ɑ p l̪ ɑ t̪ ɪ t̪ ɪ
могили	m ɔ ɦ ɪ l̪ ɪ
лічені	lʲ i t̪ ʃ ɛ n̪ʲ i
відповісти	v i d̪ p ɔ v i s̪ t̪ ɪ
Захід	z̪ ɑ x i d̪
глина	ɦ l̪ ɪ n̪ ɑ
бризнула	b r ɪ z̪ n̪ u l̪ ɑ
трьома	t̪ rʲ ɔ m ɑ
кров'яними	k r ɔ v j ɑ n̪ ɪ m ɪ
крапельками	k r ɑ p ɛ lʲ k ɑ m ɪ
білу	b i l̪ u
сорочку	s̪ ɔ r ɔ t̪ ʃ k u
раунді	r ɑ u n̪ d̪ʲ i
зіграє	z̪ʲ i ɦ r ɑ ɛ
Олімпіакосом	ɔ lʲ i m p i ɑ k ɔ s̪ ɔ m
свідомості	s̪ v i d̪ ɔ m ɔ s̪ t̪ i
етапу	ɛ t̪ ɑ p u
тренування	t̪ r ɛ n̪ u v ɑ n̪ n̪ʲ ɑ
двір	d̪ v i r
урядів	u rʲ ɑ d̪ʲ i v
інтелектуальної	i n̪ t̪ ɛ l̪ ɛ k t̪ u ɑ lʲ n̪ ɔ j i
медалей	m ɛ d̪ ɑ l̪ ɛ j
енергії	ɛ n̪ ɛ r ɦ i j i
освіта	ɔ s̪ v i t̪ ɑ
боротьбу	b ɔ r ɔ t̪ b u
Інтернет	i n̪ t̪ ɛ r n̪ ɛ t̪
генеральського	ɦ ɛ n̪ ɛ r ɑ lʲ s̪ k ɔ ɦ ɔ
негативно	n̪ ɛ ɦ ɑ t̪ ɪ v n̪ ɔ
Чіпці	t̪ ʃ i p t̪s̪ʲ i
крізь	k rʲ i z̪ʲ
загроза	z̪ ɑ ɦ r ɔ z̪ ɑ
військові	v i j s̪ k ɔ v i
внутрішню	v n̪ u t̪ rʲ i ʃ n̪ʲ u
християнське	x r ɪ s̪ t̪ ɪ ɑ n̪ s̪ k ɛ
прощення	p r ɔ ʃ t̪ ʃ ɛ n̪ n̪ʲ ɑ
забуття	z̪ ɑ b u t̪ t̪ ɑ
Тетяни	t̪ ɛ t̪ ɑ n̪ ɪ
вивіряла	v ɪ v i rʲ ɑ l̪ ɑ
пропонували	p r ɔ p ɔ n̪ u v ɑ l̪ ɪ
тринадцять	t̪ r ɪ n̪ ɑ d̪ t̪s̪ʲ ɑ t̪
поверхів	p ɔ v ɛ r x i v
оберемок	ɔ b ɛ r ɛ m ɔ k
свіжої	s̪ v i ʒ ɔ j i
прийом	p r ɪ j ɔ m
випустив	v ɪ p u s̪ t̪ ɪ v
корову	k ɔ r ɔ v u
дитячий	d̪ ɪ t̪ ɑ t̪ ʃ ɪ j
посилав	p ɔ s̪ ɪ l̪ ɑ v
сіллю	s̪ i l̪ lʲ u
рибою	r ɪ b ɔ u
повечеряли	p ɔ v ɛ t̪ ʃ ɛ rʲ ɑ l̪ ɪ
полягали	p ɔ lʲ ɑ ɦ ɑ l̪ ɪ
спати	s̪ p ɑ t̪ ɪ
Кубань	k u b ɑ n̪ʲ
залік	z̪ ɑ lʲ i k
Ірану	i r ɑ n̪ u
Туреччини	t̪ u r ɛ t̪ ʃ t̪ ʃ ɪ n̪ ɪ
засудили	z̪ ɑ s̪ u d̪ ɪ l̪ ɪ
московських	m ɔ s̪ k ɔ v s̪ k ɪ x
археологи	ɑ r x ɛ ɔ l̪ ɔ ɦ ɪ
дістали	d̪ʲ i s̪ t̪ ɑ l̪ ɪ
останки	ɔ s̪ t̪ ɑ n̪ k ɪ
Кличка	k l̪ ɪ t̪ ʃ k ɑ
влучити	v l̪ u t̪ ʃ ɪ t̪ ɪ
Мормека	m ɔ r m ɛ k ɑ
запрошення	z̪ ɑ p r ɔ ʃ ɛ n̪ n̪ʲ ɑ
мера	m ɛ r ɑ
подолати	p ɔ d̪ ɔ l̪ ɑ t̪ ɪ
Максимові	m ɑ k s̪ ɪ m ɔ v i
переробки	p ɛ r ɛ r ɔ b k ɪ
звільнили	z̪ v i lʲ n̪ ɪ l̪ ɪ
зіграли	z̪ʲ i ɦ r ɑ l̪ ɪ
Мєдвєдєв	m ɛ d̪ v ɛ d̪ʲ ɛ v
простір	p r ɔ s̪ t̪ i r
духовної	d̪ u x ɔ v n̪ ɔ j i
продати	p r ɔ d̪ ɑ t̪ ɪ
політичним	p ɔ lʲ i t̪ ɪ t̪ ʃ n̪ ɪ m
інвестиції	i n̪ v ɛ s̪ t̪ ɪ t̪s̪ʲ i j i
проекті	p r ɔ ɛ k t̪ i
Азовмаш	ɑ z̪ ɔ v m ɑ ʃ
реванш	r ɛ v ɑ n̪ ʃ
Ферро	f ɛ r r ɔ
розгромно	r ɔ z̪ ɦ r ɔ m n̪ ɔ
програла	p r ɔ ɦ r ɑ l̪ ɑ
Румунії	r u m u n̪ʲ i j i
дозволяють	d̪ ɔ z̪ v ɔ lʲ ɑ u t̪
відчути	v i d̪ t̪ ʃ u t̪ ɪ
характеру	x ɑ r ɑ k t̪ ɛ r u
більша	b i lʲ ʃ ɑ
виступив	v ɪ s̪ t̪ u p ɪ v
окремих	ɔ k r ɛ m ɪ x
віршів	v i r ʃ i v
можливий	m ɔ ʒ l̪ ɪ v ɪ j
членами	t̪ ʃ l̪ ɛ n̪ ɑ m ɪ
чергової	t̪ ʃ ɛ r ɦ ɔ v ɔ j i
рот	r ɔ t̪
ковток	k ɔ v t̪ ɔ k
скривила	s̪ k r ɪ v ɪ l̪ ɑ
губи	ɦ u b ɪ
приймає	p r ɪ j m ɑ ɛ
демократичного	d̪ ɛ m ɔ k r ɑ t̪ ɪ t̪ ʃ n̪ ɔ ɦ ɔ
Павле	p ɑ v l̪ ɛ
надійним	n̪ ɑ d̪ʲ i j n̪ ɪ m
партнером	p ɑ r t̪ n̪ ɛ r ɔ m
експортерів	ɛ k s̪ p ɔ r t̪ ɛ rʲ i v
пшениці	p ʃ ɛ n̪ ɪ t̪s̪ʲ i
принципово	p r ɪ n̪ t̪s̪ ɪ p ɔ v ɔ
розташування	r ɔ z̪ t̪ ɑ ʃ u v ɑ n̪ n̪ʲ ɑ
церкву	t̪s̪ ɛ r k v u
питаннях	p ɪ t̪ ɑ n̪ n̪ʲ ɑ x
законопроекту	z̪ ɑ k ɔ n̪ ɔ p r ɔ ɛ k t̪ u
доноситься	d̪ ɔ n̪ ɔ s̪ ɪ t̪ s̪ ɑ
срібний	s̪ rʲ i b n̪ ɪ j
дзвіночок	d̪ z̪ v i n̪ ɔ t̪ ʃ ɔ k
перехрестився	p ɛ r ɛ x r ɛ s̪ t̪ ɪ v s̪ ɑ
водопостачання	v ɔ d̪ ɔ p ɔ s̪ t̪ ɑ t̪ ʃ ɑ n̪ n̪ʲ ɑ
частки	t̪ ʃ ɑ s̪ t̪ k ɪ
незалежні	n̪ ɛ z̪ ɑ l̪ ɛ ʒ n̪ʲ i
дослідження	d̪ ɔ s̪ lʲ i d̪ ʒ ɛ n̪ n̪ʲ ɑ
заслуговує	z̪ ɑ s̪ l̪ u ɦ ɔ v u ɛ
чотирнадцятій	t̪ ʃ ɔ t̪ ɪ r n̪ ɑ d̪ t̪s̪ʲ ɑ t̪ i j
політичну	p ɔ lʲ i t̪ ɪ t̪ ʃ n̪ u
сільського	s̪ i lʲ s̪ k ɔ ɦ ɔ
волосся	v ɔ l̪ ɔ s̪ s̪ ɑ
прямісінько	p rʲ ɑ m i s̪ i n̪ʲ k ɔ
Надія	n̪ ɑ d̪ʲ i ɑ
видав	v ɪ d̪ ɑ v
тип	t̪ ɪ p
осталося	ɔ s̪ t̪ ɑ l̪ ɔ s̪ ɑ
шкода	ʃ k ɔ d̪ ɑ
синок	s̪ ɪ n̪ ɔ k
рідко	rʲ i d̪ k ɔ
чемпіонатів	t̪ ʃ ɛ m p i ɔ n̪ ɑ t̪ i v
розмірі	r ɔ z̪ m i rʲ i
сприяння	s̪ p r ɪ ɑ n̪ n̪ʲ ɑ
нести	n̪ ɛ s̪ t̪ ɪ
рад	r ɑ d̪
аграрної	ɑ ɦ r ɑ r n̪ ɔ j i
продовольства	p r ɔ d̪ ɔ v ɔ lʲ s̪ t̪ v ɑ
лідером	lʲ i d̪ ɛ r ɔ m
закордонних	z̪ ɑ k ɔ r d̪ ɔ n̪ n̪ ɪ x
зібрано	z̪ʲ i b r ɑ n̪ ɔ
ходили	x ɔ d̪ ɪ l̪ ɪ
відпочинок	v i d̪ p ɔ t̪ ʃ ɪ n̪ ɔ k
сподівається	s̪ p ɔ d̪ʲ i v ɑ ɛ t̪ s̪ ɑ
завершити	z̪ ɑ v ɛ r ʃ ɪ t̪ ɪ
важка	v ɑ ʒ k ɑ
Долгополова	d̪ ɔ l̪ ɦ ɔ p ɔ l̪ ɔ v ɑ
ефективно	ɛ f ɛ k t̪ ɪ v n̪ ɔ
чемпіонатом	t̪ ʃ ɛ m p i ɔ n̪ ɑ t̪ ɔ m
підставі	p i d̪ s̪ t̪ ɑ v i
правосуддя	p r ɑ v ɔ s̪ u d̪ d̪ʲ ɑ
музичні	m u z̪ ɪ t̪ ʃ n̪ʲ i
напрямки	n̪ ɑ p rʲ ɑ m k ɪ
джаз	d̪ ʒ ɑ z̪
соул	s̪ ɔ u l̪
рокнролл	r ɔ k n̪ r ɔ l̪ l̪
додаткові	d̪ ɔ d̪ ɑ t̪ k ɔ v i
відтепер	v i d̪ t̪ ɛ p ɛ r
багатство	b ɑ ɦ ɑ t̪ s̪ t̪ v ɔ
комунальні	k ɔ m u n̪ ɑ lʲ n̪ʲ i
арешту	ɑ r ɛ ʃ t̪ u
передачу	p ɛ r ɛ d̪ ɑ t̪ ʃ u
державній	d̪ ɛ r ʒ ɑ v n̪ʲ i j
міжнародному	m i ʒ n̪ ɑ r ɔ d̪ n̪ ɔ m u
пам'ятали	p ɑ m j ɑ t̪ ɑ l̪ ɪ
розповіли	r ɔ z̪ p ɔ v i l̪ ɪ
спільноти	s̪ p i lʲ n̪ ɔ t̪ ɪ
удару	u d̪ ɑ r u
об	ɔ b
дівчинці	d̪ʲ i v t̪ ʃ ɪ n̪ t̪s̪ʲ i
читав	t̪ ʃ ɪ t̪ ɑ v
тексти	t̪ ɛ k s̪ t̪ ɪ
вдруге	v d̪ r u ɦ ɛ
дружби	d̪ r u ʒ b ɪ
народами	n̪ ɑ r ɔ d̪ ɑ m ɪ
хрест	x r ɛ s̪ t̪
цими	t̪s̪ ɪ m ɪ
придбав	p r ɪ d̪ b ɑ v
крісло	k rʲ i s̪ l̪ ɔ
дитячому	d̪ ɪ t̪ ɑ t̪ ʃ ɔ m u
пустив	p u s̪ t̪ ɪ v
сяють	s̪ ɑ u t̪
ясні	j ɑ s̪ n̪ʲ i
Римі	r ɪ m i
обступили	ɔ b s̪ t̪ u p ɪ l̪ ɪ
відносно	v i d̪ n̪ ɔ s̪ n̪ ɔ
знаходять	z̪ n̪ ɑ x ɔ d̪ʲ ɑ t̪
образи	ɔ b r ɑ z̪ ɪ
обставини	ɔ b s̪ t̪ ɑ v ɪ n̪ ɪ
роботодавців	r ɔ b ɔ t̪ ɔ d̪ ɑ v t̪s̪ʲ i v
обсягу	ɔ b s̪ ɑ ɦ u
змушений	z̪ m u ʃ ɛ n̪ ɪ j
двохтисячний	d̪ v ɔ x t̪ ɪ s̪ ɑ t̪ ʃ n̪ ɪ j
почуття	p ɔ t̪ ʃ u t̪ t̪ ɑ
п'яніти	p j ɑ n̪ʲ i t̪ ɪ
дешевого	d̪ ɛ ʃ ɛ v ɔ ɦ ɔ
бачитися	b ɑ t̪ ʃ ɪ t̪ ɪ s̪ ɑ
укладення	u k l̪ ɑ d̪ ɛ n̪ n̪ʲ ɑ
ветерани	v ɛ t̪ ɛ r ɑ n̪ ɪ
теракти	t̪ ɛ r ɑ k t̪ ɪ
горя	ɦ ɔ rʲ ɑ
співатиму	s̪ p i v ɑ t̪ ɪ m u
бринітиме	b r ɪ n̪ʲ i t̪ ɪ m ɛ
кришталь	k r ɪ ʃ t̪ ɑ lʲ
страшно	s̪ t̪ r ɑ ʃ n̪ ɔ
позовом	p ɔ z̪ ɔ v ɔ m
стосуються	s̪ t̪ ɔ s̪ u u t̪ s̪ ɑ
внесені	v n̪ ɛ s̪ ɛ n̪ʲ i
конституційних	k ɔ n̪ s̪ t̪ ɪ t̪ u t̪s̪ʲ i j n̪ ɪ x
бюджетів	b u d̪ ʒ ɛ t̪ i v
Олега	ɔ l̪ ɛ ɦ ɑ
учасником	u t̪ ʃ ɑ s̪ n̪ ɪ k ɔ m
здамся	z̪ d̪ ɑ m s̪ ɑ
центрів	t̪s̪ ɛ n̪ t̪ rʲ i v
Саакашвілі	s̪ ɑ ɑ k ɑ ʃ v i lʲ i
зернових	z̪ ɛ r n̪ ɔ v ɪ x
культур	k u lʲ t̪ u r
виставці	v ɪ s̪ t̪ ɑ v t̪s̪ʲ i
Радянському	r ɑ d̪ʲ ɑ n̪ s̪ k ɔ m u
лиш	l̪ ɪ ʃ
сон	s̪ ɔ n̪
дах	d̪ ɑ x
козацького	k ɔ z̪ ɑ t̪s̪ʲ k ɔ ɦ ɔ
роду	r ɔ d̪ u
реальності	r ɛ ɑ lʲ n̪ ɔ s̪ t̪ i
Фонду	f ɔ n̪ d̪ u
Афганістані	ɑ f ɦ ɑ n̪ʲ i s̪ t̪ ɑ n̪ʲ i
узяти	u z̪ʲ ɑ t̪ ɪ
медіа	m ɛ d̪ʲ i ɑ
долари	d̪ ɔ l̪ ɑ r ɪ
банкам	b ɑ n̪ k ɑ m
втілення	v t̪ i l̪ ɛ n̪ n̪ʲ ɑ
реконструкцію	r ɛ k ɔ n̪ s̪ t̪ r u k t̪s̪ʲ i u
мереж	m ɛ r ɛ ʒ
полетіла	p ɔ l̪ ɛ t̪ i l̪ ɑ
космос	k ɔ s̪ m ɔ s̪
оформлення	ɔ f ɔ r m l̪ ɛ n̪ n̪ʲ ɑ
візи	v i z̪ ɪ
завершився	z̪ ɑ v ɛ r ʃ ɪ v s̪ ɑ
обсяги	ɔ b s̪ ɑ ɦ ɪ
зросли	z̪ r ɔ s̪ l̪ ɪ
лінь	lʲ i n̪ʲ
розбудити	r ɔ z̪ b u d̪ ɪ t̪ ɪ
сплячу	s̪ p lʲ ɑ t̪ ʃ u
красуню	k r ɑ s̪ u n̪ʲ u
Конституційний	k ɔ n̪ s̪ t̪ ɪ t̪ u t̪s̪ʲ i j n̪ ɪ j
галузь	ɦ ɑ l̪ u z̪ʲ
вкладати	v k l̪ ɑ d̪ ɑ t̪ ɪ
вільні	v i lʲ n̪ʲ i
степи	s̪ t̪ ɛ p ɪ
надавати	n̪ ɑ d̪ ɑ v ɑ t̪ ɪ
девальвації	d̪ ɛ v ɑ lʲ v ɑ t̪s̪ʲ i j i
обсягів	ɔ b s̪ ɑ ɦ i v
промислового	p r ɔ m ɪ s̪ l̪ ɔ v ɔ ɦ ɔ
виконано	v ɪ k ɔ n̪ ɑ n̪ ɔ
водою	v ɔ d̪ ɔ u
Геннадій	ɦ ɛ n̪ n̪ ɑ d̪ʲ i j
Михайло	m ɪ x ɑ j l̪ ɔ
спеціального	s̪ p ɛ t̪s̪ʲ i ɑ lʲ n̪ ɔ ɦ ɔ
вип'єш	v ɪ p j ɛ ʃ
чарці	t̪ ʃ ɑ r t̪s̪ʲ i
фінансового	f i n̪ ɑ n̪ s̪ ɔ v ɔ ɦ ɔ
оперативно	ɔ p ɛ r ɑ t̪ ɪ v n̪ ɔ
чоботи	t̪ ʃ ɔ b ɔ t̪ ɪ
згадує	z̪ ɦ ɑ d̪ u ɛ
колишні	k ɔ l̪ ɪ ʃ n̪ʲ i
медичної	m ɛ d̪ ɪ t̪ ʃ n̪ ɔ j i
слові	s̪ l̪ ɔ v i
вступила	v s̪ t̪ u p ɪ l̪ ɑ
бідненько	b i d̪ n̪ ɛ n̪ʲ k ɔ
зодягнена	z̪ ɔ d̪ʲ ɑ ɦ n̪ ɛ n̪ ɑ
співпраця	s̪ p i v p r ɑ t̪s̪ʲ ɑ
гонка	ɦ ɔ n̪ k ɑ
Універсіаді	u n̪ʲ i v ɛ r s̪ i ɑ d̪ʲ i
Миколаїв	m ɪ k ɔ l̪ ɑ j i v
випустили	v ɪ p u s̪ t̪ ɪ l̪ ɪ
тридцяте	t̪ r ɪ d̪ t̪s̪ʲ ɑ t̪ ɛ
вчителів	v t̪ ʃ ɪ t̪ ɛ lʲ i v
прощайте	p r ɔ ʃ t̪ ʃ ɑ j t̪ ɛ
щасливо	ʃ t̪ ʃ ɑ s̪ l̪ ɪ v ɔ
тонкі	t̪ ɔ n̪ k i
виключено	v ɪ k lʲ u t̪ ʃ ɛ n̪ ɔ
цілей	t̪s̪ʲ i l̪ ɛ j
знаєш	z̪ n̪ ɑ ɛ ʃ
теплохід	t̪ ɛ p l̪ ɔ x i d̪
затонув	z̪ ɑ t̪ ɔ n̪ u v
тринадцятій	t̪ r ɪ n̪ ɑ d̪ t̪s̪ʲ ɑ t̪ i j
недолі	n̪ ɛ d̪ ɔ lʲ i
заслоню	z̪ ɑ s̪ l̪ ɔ n̪ʲ u
грудьми	ɦ r u d̪ʲ m ɪ
згори	z̪ ɦ ɔ r ɪ
лине	l̪ ɪ n̪ ɛ
жайворонкова	ʒ ɑ j v ɔ r ɔ n̪ k ɔ v ɑ
пісня	p i s̪ n̪ʲ ɑ
певним	p ɛ v n̪ ɪ m
чинником	t̪ ʃ ɪ n̪ n̪ ɪ k ɔ m
порівняно	p ɔ rʲ i v n̪ʲ ɑ n̪ ɔ
Греції	ɦ r ɛ t̪s̪ʲ i j i
угод	u ɦ ɔ d̪
піщанський	p i ʃ t̪ ʃ ɑ n̪ s̪ k ɪ j
козак	k ɔ z̪ ɑ k
Макарович	m ɑ k ɑ r ɔ v ɪ t̪ ʃ
Хрущ	x r u ʃ t̪ ʃ
покрутив	p ɔ k r u t̪ ɪ v
рудого	r u d̪ ɔ ɦ ɔ
уса	u s̪ ɑ
очікування	ɔ t̪ ʃ i k u v ɑ n̪ n̪ʲ ɑ
розчарування	r ɔ z̪ t̪ ʃ ɑ r u v ɑ n̪ n̪ʲ ɑ
лист	l̪ ɪ s̪ t̪
фільм	f i lʲ m
згадують	z̪ ɦ ɑ d̪ u u t̪
підприємець	p i d̪ p r ɪ ɛ m ɛ t̪s̪ʲ
ділянки	d̪ʲ i lʲ ɑ n̪ k ɪ
Грузія	ɦ r u z̪ʲ i ɑ
майбутніх	m ɑ j b u t̪ n̪ʲ i x
ухвалення	u x v ɑ l̪ ɛ n̪ n̪ʲ ɑ
внесено	v n̪ ɛ s̪ ɛ n̪ ɔ
лікаря	lʲ i k ɑ rʲ ɑ
підручник	p i d̪ r u t̪ ʃ n̪ ɪ k
симпатизую	s̪ ɪ m p ɑ t̪ ɪ z̪ u u
Італії	i t̪ ɑ lʲ i j i
грі	ɦ rʲ i
міжнародної	m i ʒ n̪ ɑ r ɔ d̪ n̪ ɔ j i
види	v ɪ d̪ ɪ
форма	f ɔ r m ɑ
гарантій	ɦ ɑ r ɑ n̪ t̪ i j
погашення	p ɔ ɦ ɑ ʃ ɛ n̪ n̪ʲ ɑ
переводив	p ɛ r ɛ v ɔ d̪ ɪ v
Мотор	m ɔ t̪ ɔ r
чвертьфінал	t̪ ʃ v ɛ r t̪ f i n̪ ɑ l̪
майданчику	m ɑ j d̪ ɑ n̪ t̪ ʃ ɪ k u
столі	s̪ t̪ ɔ lʲ i
гірший	ɦ i r ʃ ɪ j
прийме	p r ɪ j m ɛ
нерадянська	n̪ ɛ r ɑ d̪ʲ ɑ n̪ s̪ k ɑ
натовп	n̪ ɑ t̪ ɔ v p
напав	n̪ ɑ p ɑ v
ДАІ	d̪ ɑ i
щиро	ʃ t̪ ʃ ɪ r ɔ
суперник	s̪ u p ɛ r n̪ ɪ k
пояснюють	p ɔ ɑ s̪ n̪ʲ u u t̪
заарештували	z̪ ɑ ɑ r ɛ ʃ t̪ u v ɑ l̪ ɪ
Верховного	v ɛ r x ɔ v n̪ ɔ ɦ ɔ
Суду	s̪ u d̪ u
надали	n̪ ɑ d̪ ɑ l̪ ɪ
практику	p r ɑ k t̪ ɪ k u
Гран	ɦ r ɑ n̪
Прі	p rʲ i
одв'язав	ɔ d̪ v j ɑ z̪ ɑ v
ясел	j ɑ s̪ ɛ l̪
кобилу	k ɔ b ɪ l̪ u
водопою	v ɔ d̪ ɔ p ɔ u
тутешні	t̪ u t̪ ɛ ʃ n̪ʲ i
коштуватиме	k ɔ ʃ t̪ u v ɑ t̪ ɪ m ɛ
удалося	u d̪ ɑ l̪ ɔ s̪ ɑ
стінами	s̪ t̪ i n̪ ɑ m ɪ
подивилася	p ɔ d̪ ɪ v ɪ l̪ ɑ s̪ ɑ
область	ɔ b l̪ ɑ s̪ t̪
потрапили	p ɔ t̪ r ɑ p ɪ l̪ ɪ
родичі	r ɔ d̪ ɪ t̪ ʃ i
слухати	s̪ l̪ u x ɑ t̪ ɪ
поклади	p ɔ k l̪ ɑ d̪ ɪ
полінах	p ɔ lʲ i n̪ ɑ x
переклад	p ɛ r ɛ k l̪ ɑ d̪
Байєр	b ɑ j ɛ r
виїзді	v ɪ j i z̪ d̪ʲ i
здолав	z̪ d̪ ɔ l̪ ɑ v
Кельн	k ɛ lʲ n̪
введено	v v ɛ d̪ ɛ n̪ ɔ
ДКЦПФР	d̪ k t̪s̪ p f r
Севастополя	s̪ ɛ v ɑ s̪ t̪ ɔ p ɔ lʲ ɑ
сучасного	s̪ u t̪ ʃ ɑ s̪ n̪ ɔ ɦ ɔ
ВВП	v v p
зріс	z̪ rʲ i s̪
Давід	d̪ ɑ v i d̪
Налбандян	n̪ ɑ l̪ b ɑ n̪ d̪ʲ ɑ n̪
Дакарі	d̪ ɑ k ɑ rʲ i
небезпеки	n̪ ɛ b ɛ z̪ p ɛ k ɪ
старті	s̪ t̪ ɑ r t̪ i
живий	ʒ ɪ v ɪ j
сфери	s̪ f ɛ r ɪ
людського	lʲ u d̪ s̪ k ɔ ɦ ɔ
нагадав	n̪ ɑ ɦ ɑ d̪ ɑ v
Forbes	f ɔ r b ɛ s̪
споживача	s̪ p ɔ ʒ ɪ v ɑ t̪ ʃ ɑ
реалії	r ɛ ɑ lʲ i j i
панові	p ɑ n̪ ɔ v i
суто	s̪ u t̪ ɔ
адвокат	ɑ d̪ v ɔ k ɑ t̪
турбує	t̪ u r b u ɛ
розрахунків	r ɔ z̪ r ɑ x u n̪ k i v
фронту	f r ɔ n̪ t̪ u
плані	p l̪ ɑ n̪ʲ i
митця	m ɪ t̪ t̪s̪ʲ ɑ
війська	v i j s̪ k ɑ
молодої	m ɔ l̪ ɔ d̪ ɔ j i
пройшовши	p r ɔ j ʃ ɔ v ʃ ɪ
структури	s̪ t̪ r u k t̪ u r ɪ
сімнадцятій	s̪ i m n̪ ɑ d̪ t̪s̪ʲ ɑ t̪ i j
хазяїн	x ɑ z̪ʲ ɑ j i n̪
реальну	r ɛ ɑ lʲ n̪ u
неба	n̪ ɛ b ɑ
питав	p ɪ t̪ ɑ v
захищу	z̪ ɑ x ɪ ʃ t̪ ʃ u
плащем	p l̪ ɑ ʃ t̪ ʃ ɛ m
місію	m i s̪ i u
Ігоря	i ɦ ɔ rʲ ɑ
громаду	ɦ r ɔ m ɑ d̪ u
торгівлею	t̪ ɔ r ɦ i v l̪ ɛ u
белебні	b ɛ l̪ ɛ b n̪ʲ i
медичного	m ɛ d̪ ɪ t̪ ʃ n̪ ɔ ɦ ɔ
житлового	ʒ ɪ t̪ l̪ ɔ v ɔ ɦ ɔ
ВТБ	v t̪ b
ланах	l̪ ɑ n̪ ɑ x
сонячна	s̪ ɔ n̪ʲ ɑ t̪ ʃ n̪ ɑ
підозрюваного	p i d̪ ɔ z̪ rʲ u v ɑ n̪ ɔ ɦ ɔ
фінансів	f i n̪ ɑ n̪ s̪ i v
працюючих	p r ɑ t̪s̪ʲ u u t̪ ʃ ɪ x
обленерго	ɔ b l̪ ɛ n̪ ɛ r ɦ ɔ
пропозицію	p r ɔ p ɔ z̪ ɪ t̪s̪ʲ i u
перебуде	p ɛ r ɛ b u d̪ ɛ
Верховній	v ɛ r x ɔ v n̪ʲ i j
Раді	r ɑ d̪ʲ i
розпочався	r ɔ z̪ p ɔ t̪ ʃ ɑ v s̪ ɑ
змаганні	z̪ m ɑ ɦ ɑ n̪ n̪ʲ i
срібним	s̪ rʲ i b n̪ ɪ m
призером	p r ɪ z̪ ɛ r ɔ m
Мовчан	m ɔ v t̪ ʃ ɑ n̪
дванадцяте	d̪ v ɑ n̪ ɑ d̪ t̪s̪ʲ ɑ t̪ ɛ
Інституту	i n̪ s̪ t̪ ɪ t̪ u t̪ u
Нідерландів	n̪ʲ i d̪ ɛ r l̪ ɑ n̪ d̪ʲ i v
посадити	p ɔ s̪ ɑ d̪ ɪ t̪ ɪ
кораблі	k ɔ r ɑ b lʲ i
інвестиційний	i n̪ v ɛ s̪ t̪ ɪ t̪s̪ʲ i j n̪ ɪ j
відкриває	v i d̪ k r ɪ v ɑ ɛ
регіону	r ɛ ɦ i ɔ n̪ u
любить	lʲ u b ɪ t̪
легкоатлетів	l̪ ɛ ɦ k ɔ ɑ t̪ l̪ ɛ t̪ i v
тенісісти	t̪ ɛ n̪ʲ i s̪ i s̪ t̪ ɪ
частин	t̪ ʃ ɑ s̪ t̪ ɪ n̪
Майдані	m ɑ j d̪ ɑ n̪ʲ i
дійсності	d̪ʲ i j s̪ n̪ ɔ s̪ t̪ i
громадянську	ɦ r ɔ m ɑ d̪ʲ ɑ n̪ s̪ k u
Гвардіола	ɦ v ɑ r d̪ʲ i ɔ l̪ ɑ
Барселоні	b ɑ r s̪ ɛ l̪ ɔ n̪ʲ i
закупівель	z̪ ɑ k u p i v ɛ lʲ
відео	v i d̪ ɛ ɔ
давайте	d̪ ɑ v ɑ j t̪ ɛ
пошуком	p ɔ ʃ u k ɔ m
інвестора	i n̪ v ɛ s̪ t̪ ɔ r ɑ
величезна	v ɛ l̪ ɪ t̪ ʃ ɛ z̪ n̪ ɑ
червоних	t̪ ʃ ɛ r v ɔ n̪ ɪ x
ані	ɑ n̪ʲ i
білих	b i l̪ ɪ x
берега	b ɛ r ɛ ɦ ɑ
Ходорковського	x ɔ d̪ ɔ r k ɔ v s̪ k ɔ ɦ ɔ
зберігати	z̪ b ɛ rʲ i ɦ ɑ t̪ ɪ
увійти	u v i j t̪ ɪ
мешкав	m ɛ ʃ k ɑ v
Майдан	m ɑ j d̪ ɑ n̪
Єгипті	j ɛ ɦ ɪ p t̪ i
основного	ɔ s̪ n̪ ɔ v n̪ ɔ ɦ ɔ
давні	d̪ ɑ v n̪ʲ i
внесення	v n̪ ɛ s̪ ɛ n̪ n̪ʲ ɑ
законодавчих	z̪ ɑ k ɔ n̪ ɔ d̪ ɑ v t̪ ʃ ɪ x
актів	ɑ k t̪ i v
книжковій	k n̪ ɪ ʒ k ɔ v i j
серії	s̪ ɛ rʲ i j i
доводилося	d̪ ɔ v ɔ d̪ ɪ l̪ ɔ s̪ ɑ
аналогічний	ɑ n̪ ɑ l̪ ɔ ɦ i t̪ ʃ n̪ ɪ j
почне	p ɔ t̪ ʃ n̪ ɛ
зверху	z̪ v ɛ r x u
Дні	d̪ n̪ʲ i
справжнім	s̪ p r ɑ v ʒ n̪ʲ i m
споруди	s̪ p ɔ r u d̪ ɪ
чемпіонату	t̪ ʃ ɛ m p i ɔ n̪ ɑ t̪ u
нав'язують	n̪ ɑ v j ɑ z̪ u u t̪
суспільний	s̪ u s̪ p i lʲ n̪ ɪ j
зуміє	z̪ u m i ɛ
печаль	p ɛ t̪ ʃ ɑ lʲ
низеньких	n̪ ɪ z̪ ɛ n̪ʲ k ɪ x
хатніх	x ɑ t̪ n̪ʲ i x
урахуванням	u r ɑ x u v ɑ n̪ n̪ʲ ɑ m
положень	p ɔ l̪ ɔ ʒ ɛ n̪ʲ
перебувала	p ɛ r ɛ b u v ɑ l̪ ɑ
сльози	s̪ lʲ ɔ z̪ ɪ
твоєму	t̪ v ɔ ɛ m u
обличчі	ɔ b l̪ ɪ t̪ ʃ t̪ ʃ i
громадські	ɦ r ɔ m ɑ d̪ s̪ k i
п'ятого	p j ɑ t̪ ɔ ɦ ɔ
стану	s̪ t̪ ɑ n̪ u
лабораторія	l̪ ɑ b ɔ r ɑ t̪ ɔ rʲ i ɑ
творчих	t̪ v ɔ r t̪ ʃ ɪ x
підходів	p i d̪ x ɔ d̪ʲ i v
практичної	p r ɑ k t̪ ɪ t̪ ʃ n̪ ɔ j i
спецслужби	s̪ p ɛ t̪s̪ s̪ l̪ u ʒ b ɪ
кодексом	k ɔ d̪ ɛ k s̪ ɔ m
передбачається	p ɛ r ɛ d̪ b ɑ t̪ ʃ ɑ ɛ t̪ s̪ ɑ
зборів	z̪ b ɔ rʲ i v
виставу	v ɪ s̪ t̪ ɑ v u
планів	p l̪ ɑ n̪ʲ i v
показника	p ɔ k ɑ z̪ n̪ ɪ k ɑ
інфляції	i n̪ f lʲ ɑ t̪s̪ʲ i j i
склало	s̪ k l̪ ɑ l̪ ɔ
одверни	ɔ d̪ v ɛ r n̪ ɪ
підписувати	p i d̪ p ɪ s̪ u v ɑ t̪ ɪ
загинула	z̪ ɑ ɦ ɪ n̪ u l̪ ɑ
Хосні	x ɔ s̪ n̪ʲ i
Мубарак	m u b ɑ r ɑ k
Іспанія	i s̪ p ɑ n̪ʲ i ɑ
чемпіон	t̪ ʃ ɛ m p i ɔ n̪
недобре	n̪ ɛ d̪ ɔ b r ɛ
дату	d̪ ɑ t̪ u
політолог	p ɔ lʲ i t̪ ɔ l̪ ɔ ɦ
служіння	s̪ l̪ u ʒ i n̪ n̪ʲ ɑ
інтересам	i n̪ t̪ ɛ r ɛ s̪ ɑ m
очолити	ɔ t̪ ʃ ɔ l̪ ɪ t̪ ɪ
Вільярреал	v i lʲ ɑ r r ɛ ɑ l̪
історичної	i s̪ t̪ ɔ r ɪ t̪ ʃ n̪ ɔ j i
стверджує	s̪ t̪ v ɛ r d̪ ʒ u ɛ
мережі	m ɛ r ɛ ʒ i
об'єднує	ɔ b j ɛ d̪ n̪ u ɛ
міліціонери	m i lʲ i t̪s̪ʲ i ɔ n̪ ɛ r ɪ
район	r ɑ j ɔ n̪
сільськогосподарських	s̪ i lʲ s̪ k ɔ ɦ ɔ s̪ p ɔ d̪ ɑ r s̪ k ɪ x
державну	d̪ ɛ r ʒ ɑ v n̪ u
вчитися	v t̪ ʃ ɪ t̪ ɪ s̪ ɑ
виникли	v ɪ n̪ ɪ k l̪ ɪ
честі	t̪ ʃ ɛ s̪ t̪ i
Яків	j ɑ k i v
Украйни	u k r ɑ j n̪ ɪ
Олімпіаді	ɔ lʲ i m p i ɑ d̪ʲ i
закладу	z̪ ɑ k l̪ ɑ d̪ u
щорічно	ʃ t̪ ʃ ɔ rʲ i t̪ ʃ n̪ ɔ
звинувачує	z̪ v ɪ n̪ u v ɑ t̪ ʃ u ɛ
червоний	t̪ ʃ ɛ r v ɔ n̪ ɪ j
поліпшити	p ɔ lʲ i p ʃ ɪ t̪ ɪ
перебування	p ɛ r ɛ b u v ɑ n̪ n̪ʲ ɑ
медичних	m ɛ d̪ ɪ t̪ ʃ n̪ ɪ x
утримання	u t̪ r ɪ m ɑ n̪ n̪ʲ ɑ
ФІФА	f i f ɑ
екології	ɛ k ɔ l̪ ɔ ɦ i j i
Людмила	lʲ u d̪ m ɪ l̪ ɑ
Межигір	m ɛ ʒ ɪ ɦ i r
пропадав	p r ɔ p ɑ d̪ ɑ v
знать	z̪ n̪ ɑ t̪
ваших	v ɑ ʃ ɪ x
спортсмен	s̪ p ɔ r t̪ s̪ m ɛ n̪
створювати	s̪ t̪ v ɔ rʲ u v ɑ t̪ ɪ
охорону	ɔ x ɔ r ɔ n̪ u
Олексія	ɔ l̪ ɛ k s̪ i ɑ
потроху	p ɔ t̪ r ɔ x u
осторонь	ɔ s̪ t̪ ɔ r ɔ n̪ʲ
чиясь	t̪ ʃ ɪ ɑ s̪
сирітська	s̪ ɪ rʲ i t̪ s̪ k ɑ
пустка	p u s̪ t̪ k ɑ
Семеновича	s̪ ɛ m ɛ n̪ ɔ v ɪ t̪ ʃ ɑ
дев'ята	d̪ ɛ v j ɑ t̪ ɑ
легенький	l̪ ɛ ɦ ɛ n̪ʲ k ɪ j
вітрець	v i t̪ r ɛ t̪s̪ʲ
подихав	p ɔ d̪ ɪ x ɑ v
теплого	t̪ ɛ p l̪ ɔ ɦ ɔ
нав'язати	n̪ ɑ v j ɑ z̪ ɑ t̪ ɪ
ветеранів	v ɛ t̪ ɛ r ɑ n̪ʲ i v
нашою	n̪ ɑ ʃ ɔ u
рідною	rʲ i d̪ n̪ ɔ u
поставить	p ɔ s̪ t̪ ɑ v ɪ t̪
громаді	ɦ r ɔ m ɑ d̪ʲ i
могоричу	m ɔ ɦ ɔ r ɪ t̪ ʃ u
споживчих	s̪ p ɔ ʒ ɪ v t̪ ʃ ɪ x
кредитів	k r ɛ d̪ ɪ t̪ i v
дивились	d̪ ɪ v ɪ l̪ ɪ s̪
услід	u s̪ lʲ i d̪
скрився	s̪ k r ɪ v s̪ ɑ
очей	ɔ t̪ ʃ ɛ j
кривій	k r ɪ v i j
біди	b i d̪ ɪ
горе	ɦ ɔ r ɛ
тьми	t̪ m ɪ
твоя	t̪ v ɔ ɑ
нарком	n̪ ɑ r k ɔ m
Кримські	k r ɪ m s̪ k i
татари	t̪ ɑ t̪ ɑ r ɪ
розглядають	r ɔ z̪ ɦ lʲ ɑ d̪ ɑ u t̪
ворожу	v ɔ r ɔ ʒ u
вірять	v i rʲ ɑ t̪
міського	m i s̪ k ɔ ɦ ɔ
знайомі	z̪ n̪ ɑ j ɔ m i
надзвичайної	n̪ ɑ d̪ z̪ v ɪ t̪ ʃ ɑ j n̪ ɔ j i
зброю	z̪ b r ɔ u
тонну	t̪ ɔ n̪ n̪ u
транспортування	t̪ r ɑ n̪ s̪ p ɔ r t̪ u v ɑ n̪ n̪ʲ ɑ
форм	f ɔ r m
історика	i s̪ t̪ ɔ r ɪ k ɑ
великій	v ɛ l̪ ɪ k i j
уроки	u r ɔ k ɪ
відзначила	v i d̪ z̪ n̪ ɑ t̪ ʃ ɪ l̪ ɑ
ювілей	j u v i l̪ ɛ j
провела	p r ɔ v ɛ l̪ ɑ
Галина	ɦ ɑ l̪ ɪ n̪ ɑ
німців	n̪ʲ i m t̪s̪ʲ i v
Радіо	r ɑ d̪ʲ i ɔ
Сокіл	s̪ ɔ k i l̪
сильнішим	s̪ ɪ lʲ n̪ʲ i ʃ ɪ m
київському	k ɪ j i v s̪ k ɔ m u
дербі	d̪ ɛ r b i
вікнами	v i k n̪ ɑ m ɪ
зник	z̪ n̪ ɪ k
політик	p ɔ lʲ i t̪ ɪ k
безпеку	b ɛ z̪ p ɛ k u
кандидатом	k ɑ n̪ d̪ ɪ d̪ ɑ t̪ ɔ m
встановлення	v s̪ t̪ ɑ n̪ ɔ v l̪ ɛ n̪ n̪ʲ ɑ
Полтавщини	p ɔ l̪ t̪ ɑ v ʃ t̪ ʃ ɪ n̪ ɪ
міжнародні	m i ʒ n̪ ɑ r ɔ d̪ n̪ʲ i
отримували	ɔ t̪ r ɪ m u v ɑ l̪ ɪ
Wikileaks	w i k i l̪ ɛ a k s̪
командами	k ɔ m ɑ n̪ d̪ ɑ m ɪ
дайте	d̪ ɑ j t̪ ɛ
листок	l̪ ɪ s̪ t̪ ɔ k
затримала	z̪ ɑ t̪ r ɪ m ɑ l̪ ɑ
незважаючи	n̪ ɛ z̪ v ɑ ʒ ɑ u t̪ ʃ ɪ
Брюсселі	b rʲ u s̪ s̪ ɛ lʲ i
Макларен	m ɑ k l̪ ɑ r ɛ n̪
затриманий	z̪ ɑ t̪ r ɪ m ɑ n̪ ɪ j
Бондаренко	b ɔ n̪ d̪ ɑ r ɛ n̪ k ɔ
регіонали	r ɛ ɦ i ɔ n̪ ɑ l̪ ɪ
алкоголем	ɑ l̪ k ɔ ɦ ɔ l̪ ɛ m
Хемілтон	x ɛ m i l̪ t̪ ɔ n̪
офіційному	ɔ f i t̪s̪ʲ i j n̪ ɔ m u
дев'ятнадцять	d̪ ɛ v j ɑ t̪ n̪ ɑ d̪ t̪s̪ʲ ɑ t̪
найбільша	n̪ ɑ j b i lʲ ʃ ɑ
очікуванні	ɔ t̪ ʃ i k u v ɑ n̪ n̪ʲ i
правил	p r ɑ v ɪ l̪
перекинувся	p ɛ r ɛ k ɪ n̪ u v s̪ ɑ
Болгарії	b ɔ l̪ ɦ ɑ rʲ i j i
якої	j ɑ k ɔ j i
пори	p ɔ r ɪ
виходив	v ɪ x ɔ d̪ ɪ v
Марк	m ɑ r k
Веббер	v ɛ b b ɛ r
продовжив	p r ɔ d̪ ɔ v ʒ ɪ v
Ред	r ɛ d̪
Булл	b u l̪ l̪
Першої	p ɛ r ʃ ɔ j i
всіма	v s̪ i m ɑ
га	ɦ ɑ
Форум	f ɔ r u m
Вітчизняні	v i t̪ t̪ ʃ ɪ z̪ n̪ʲ ɑ n̪ʲ i
Нашій	n̪ ɑ ʃ i j
всіляко	v s̪ i lʲ ɑ k ɔ
Гладкий	ɦ l̪ ɑ d̪ k ɪ j
повітря	p ɔ v i t̪ rʲ ɑ
частини	t̪ ʃ ɑ s̪ t̪ ɪ n̪ ɪ
вісімнадцять	v i s̪ i m n̪ ɑ d̪ t̪s̪ʲ ɑ t̪
військових	v i j s̪ k ɔ v ɪ x
вчинити	v t̪ ʃ ɪ n̪ ɪ t̪ ɪ
опір	ɔ p i r
хвилі	x v ɪ lʲ i
фанів	f ɑ n̪ʲ i v
згаданий	z̪ ɦ ɑ d̪ ɑ n̪ ɪ j
підготувати	p i d̪ ɦ ɔ t̪ u v ɑ t̪ ɪ
відчуваю	v i d̪ t̪ ʃ u v ɑ u
домовились	d̪ ɔ m ɔ v ɪ l̪ ɪ s̪
консультації	k ɔ n̪ s̪ u lʲ t̪ ɑ t̪s̪ʲ i j i
прийняті	p r ɪ j n̪ʲ ɑ t̪ i
Ромко	r ɔ m k ɔ
навчався	n̪ ɑ v t̪ ʃ ɑ v s̪ ɑ
гімназії	ɦ i m n̪ ɑ z̪ʲ i j i
дотримуватися	d̪ ɔ t̪ r ɪ m u v ɑ t̪ ɪ s̪ ɑ
своєю	s̪ v ɔ ɛ u
значна	z̪ n̪ ɑ t̪ ʃ n̪ ɑ
безпека	b ɛ z̪ p ɛ k ɑ
тою	t̪ ɔ u
тропою	t̪ r ɔ p ɔ u
розказала	r ɔ z̪ k ɑ z̪ ɑ l̪ ɑ
прагнули	p r ɑ ɦ n̪ u l̪ ɪ
якоюсь	j ɑ k ɔ u s̪
хижою	x ɪ ʒ ɔ u
тугою	t̪ u ɦ ɔ u
шістнадцятій	ʃ i s̪ t̪ n̪ ɑ d̪ t̪s̪ʲ ɑ t̪ i j
виразно	v ɪ r ɑ z̪ n̪ ɔ
розтоплене	r ɔ z̪ t̪ ɔ p l̪ ɛ n̪ ɛ
ллється	l̪ lʲ ɛ t̪ s̪ ɑ
блискучий	b l̪ ɪ s̪ k u t̪ ʃ ɪ j
кухні	k u x n̪ʲ i
грунт	ɦ r u n̪ t̪
вихідні	v ɪ x i d̪ n̪ʲ i
вважається	v v ɑ ʒ ɑ ɛ t̪ s̪ ɑ
домогтися	d̪ ɔ m ɔ ɦ t̪ ɪ s̪ ɑ
певних	p ɛ v n̪ ɪ x
група	ɦ r u p ɑ
депутатами	d̪ ɛ p u t̪ ɑ t̪ ɑ m ɪ
вивезли	v ɪ v ɛ z̪ l̪ ɪ
видів	v ɪ d̪ʲ i v
стані	s̪ t̪ ɑ n̪ʲ i
лайно	l̪ ɑ j n̪ ɔ
чотирнадцять	t̪ ʃ ɔ t̪ ɪ r n̪ ɑ d̪ t̪s̪ʲ ɑ t̪
домівок	d̪ ɔ m i v ɔ k
торкається	t̪ ɔ r k ɑ ɛ t̪ s̪ ɑ
перетворюється	p ɛ r ɛ t̪ v ɔ rʲ u ɛ t̪ s̪ ɑ
вісімдесяті	v i s̪ i m d̪ ɛ s̪ ɑ t̪ i
посприяли	p ɔ s̪ p r ɪ ɑ l̪ ɪ
бюро	b u r ɔ
скористатися	s̪ k ɔ r ɪ s̪ t̪ ɑ t̪ ɪ s̪ ɑ
видається	v ɪ d̪ ɑ ɛ t̪ s̪ ɑ
призначений	p r ɪ z̪ n̪ ɑ t̪ ʃ ɛ n̪ ɪ j
відстані	v i d̪ s̪ t̪ ɑ n̪ʲ i
подальшого	p ɔ d̪ ɑ lʲ ʃ ɔ ɦ ɔ
пострадянських	p ɔ s̪ t̪ r ɑ d̪ʲ ɑ n̪ s̪ k ɪ x
Зеніт	z̪ ɛ n̪ʲ i t̪
нападника	n̪ ɑ p ɑ d̪ n̪ ɪ k ɑ
Інтера	i n̪ t̪ ɛ r ɑ
економіці	ɛ k ɔ n̪ ɔ m i t̪s̪ʲ i
залишила	z̪ ɑ l̪ ɪ ʃ ɪ l̪ ɑ
клас	k l̪ ɑ s̪
українця	u k r ɑ j i n̪ t̪s̪ʲ ɑ
кріпитимуть	k rʲ i p ɪ t̪ ɪ m u t̪
зняти	z̪ n̪ʲ ɑ t̪ ɪ
пошкоджень	p ɔ ʃ k ɔ d̪ ʒ ɛ n̪ʲ
терміни	t̪ ɛ r m i n̪ ɪ
Рита	r ɪ t̪ ɑ
Порошенка	p ɔ r ɔ ʃ ɛ n̪ k ɑ
білого	b i l̪ ɔ ɦ ɔ
нападник	n̪ ɑ p ɑ d̪ n̪ ɪ k
форвард	f ɔ r v ɑ r d̪
провінції	p r ɔ v i n̪ t̪s̪ʲ i j i
закінчується	z̪ ɑ k i n̪ t̪ ʃ u ɛ t̪ s̪ ɑ
звідтіля	z̪ v i d̪ t̪ i lʲ ɑ
платить	p l̪ ɑ t̪ ɪ t̪
горілкою	ɦ ɔ rʲ i l̪ k ɔ u
заборонив	z̪ ɑ b ɔ r ɔ n̪ ɪ v
офіційних	ɔ f i t̪s̪ʲ i j n̪ ɪ x
відповідної	v i d̪ p ɔ v i d̪ n̪ ɔ j i
постанови	p ɔ s̪ t̪ ɑ n̪ ɔ v ɪ
пройдуть	p r ɔ j d̪ u t̪
жиди	ʒ ɪ d̪ ɪ
міжнародного	m i ʒ n̪ ɑ r ɔ d̪ n̪ ɔ ɦ ɔ
номер	n̪ ɔ m ɛ r
тиха	t̪ ɪ x ɑ
зірок	z̪ʲ i r ɔ k
незалежна	n̪ ɛ z̪ ɑ l̪ ɛ ʒ n̪ ɑ
гласні	ɦ l̪ ɑ s̪ n̪ʲ i
Герой	ɦ ɛ r ɔ j
становище	s̪ t̪ ɑ n̪ ɔ v ɪ ʃ t̪ ʃ ɛ
бесіди	b ɛ s̪ i d̪ ɪ
АМКУ	ɑ m k u
видобутку	v ɪ d̪ ɔ b u t̪ k u
реагувати	r ɛ ɑ ɦ u v ɑ t̪ ɪ
просився	p r ɔ s̪ ɪ v s̪ ɑ
Луганської	l̪ u ɦ ɑ n̪ s̪ k ɔ j i
партій	p ɑ r t̪ i j
договором	d̪ ɔ ɦ ɔ v ɔ r ɔ m
Нафтогазом	n̪ ɑ f t̪ ɔ ɦ ɑ z̪ ɔ m
зранку	z̪ r ɑ n̪ k u
режимі	r ɛ ʒ ɪ m i
позабирали	p ɔ z̪ ɑ b ɪ r ɑ l̪ ɪ
торби	t̪ ɔ r b ɪ
роману	r ɔ m ɑ n̪ u
Київська	k ɪ j i v s̪ k ɑ
адміністрація	ɑ d̪ m i n̪ʲ i s̪ t̪ r ɑ t̪s̪ʲ i ɑ
таймі	t̪ ɑ j m i
глядачів	ɦ lʲ ɑ d̪ ɑ t̪ ʃ i v
удостоєний	u d̪ ɔ s̪ t̪ ɔ ɛ n̪ ɪ j
артиста	ɑ r t̪ ɪ s̪ t̪ ɑ
прив'язаний	p r ɪ v j ɑ z̪ ɑ n̪ ɪ j
Моурінью	m ɔ u rʲ i n̪ʲ u
стабільність	s̪ t̪ ɑ b i lʲ n̪ʲ i s̪ t̪
Запорізької	z̪ ɑ p ɔ rʲ i z̪ʲ k ɔ j i
Одеської	ɔ d̪ ɛ s̪ k ɔ j i
російську	r ɔ s̪ i j s̪ k u
імперію	i m p ɛ rʲ i u
Івась	i v ɑ s̪
стаття	s̪ t̪ ɑ t̪ t̪ ɑ
вищою	v ɪ ʃ t̪ ʃ ɔ u
істотно	i s̪ t̪ ɔ t̪ n̪ ɔ
сином	s̪ ɪ n̪ ɔ m
дев'яності	d̪ ɛ v j ɑ n̪ ɔ s̪ t̪ i
нараховувалося	n̪ ɑ r ɑ x ɔ v u v ɑ l̪ ɔ s̪ ɑ
рокгруп	r ɔ k ɦ r u p
гідно	ɦ i d̪ n̪ ɔ
конкурувати	k ɔ n̪ k u r u v ɑ t̪ ɪ
нехрещена	n̪ ɛ x r ɛ ʃ t̪ ʃ ɛ n̪ ɑ
причетність	p r ɪ t̪ ʃ ɛ t̪ n̪ʲ i s̪ t̪
кращого	k r ɑ ʃ t̪ ʃ ɔ ɦ ɔ
гравця	ɦ r ɑ v t̪s̪ʲ ɑ
турніру	t̪ u r n̪ʲ i r u
гравець	ɦ r ɑ v ɛ t̪s̪ʲ
прибула	p r ɪ b u l̪ ɑ
Перший	p ɛ r ʃ ɪ j
оприлюднив	ɔ p r ɪ lʲ u d̪ n̪ ɪ v
охоче	ɔ x ɔ t̪ ʃ ɛ
коаліції	k ɔ ɑ lʲ i t̪s̪ʲ i j i
додає	d̪ ɔ d̪ ɑ ɛ
безробітних	b ɛ z̪ r ɔ b i t̪ n̪ ɪ x
здійснюється	z̪ d̪ʲ i j s̪ n̪ʲ u ɛ t̪ s̪ ɑ
підготовка	p i d̪ ɦ ɔ t̪ ɔ v k ɑ
вивчити	v ɪ v t̪ ʃ ɪ t̪ ɪ
Гм	ɦ m
Васильович	v ɑ s̪ ɪ lʲ ɔ v ɪ t̪ ʃ
плямочки	p lʲ ɑ m ɔ t̪ ʃ k ɪ
хмарочки	x m ɑ r ɔ t̪ ʃ k ɪ
чисте	t̪ ʃ ɪ s̪ t̪ ɛ
прозоре	p r ɔ z̪ ɔ r ɛ
тоне	t̪ ɔ n̪ ɛ
Чехії	t̪ ʃ ɛ x i j i
глянула	ɦ lʲ ɑ n̪ u l̪ ɑ
перегодя	p ɛ r ɛ ɦ ɔ d̪ʲ ɑ
категорії	k ɑ t̪ ɛ ɦ ɔ rʲ i j i
послужив	p ɔ s̪ l̪ u ʒ ɪ v
розмові	r ɔ z̪ m ɔ v i
кидається	k ɪ d̪ ɑ ɛ t̪ s̪ ɑ
обоє	ɔ b ɔ ɛ
п'ятнадцятій	p j ɑ t̪ n̪ ɑ d̪ t̪s̪ʲ ɑ t̪ i j
повною	p ɔ v n̪ ɔ u
світилася	s̪ v i t̪ ɪ l̪ ɑ s̪ ɑ
незвичайна	n̪ ɛ z̪ v ɪ t̪ ʃ ɑ j n̪ ɑ
сміливість	s̪ m i l̪ ɪ v i s̪ t̪
духова	d̪ u x ɔ v ɑ
міць	m i t̪s̪ʲ
текст	t̪ ɛ k s̪ t̪
музику	m u z̪ ɪ k u
повелося	p ɔ v ɛ l̪ ɔ s̪ ɑ
одягу	ɔ d̪ʲ ɑ ɦ u
віри	v i r ɪ
ідеології	i d̪ ɛ ɔ l̪ ɔ ɦ i j i
братися	b r ɑ t̪ ɪ s̪ ɑ
одиннадцятої	ɔ d̪ ɪ n̪ n̪ ɑ d̪ t̪s̪ʲ ɑ t̪ ɔ j i
Черкаси	t̪ ʃ ɛ r k ɑ s̪ ɪ
ішли	i ʃ l̪ ɪ
читачами	t̪ ʃ ɪ t̪ ɑ t̪ ʃ ɑ m ɪ
жид	ʒ ɪ d̪
подання	p ɔ d̪ ɑ n̪ n̪ʲ ɑ
припадає	p r ɪ p ɑ d̪ ɑ ɛ
Марченко	m ɑ r t̪ ʃ ɛ n̪ k ɔ
основну	ɔ s̪ n̪ ɔ v n̪ u
сітку	s̪ i t̪ k u
чом	t̪ ʃ ɔ m
скажеш	s̪ k ɑ ʒ ɛ ʃ
сюжет	s̪ u ʒ ɛ t̪
здивований	z̪ d̪ ɪ v ɔ v ɑ n̪ ɪ j
швидкістю	ʃ v ɪ d̪ k i s̪ t̪ u
завдань	z̪ ɑ v d̪ ɑ n̪ʲ
підприємствах	p i d̪ p r ɪ ɛ m s̪ t̪ v ɑ x
старший	s̪ t̪ ɑ r ʃ ɪ j
корова	k ɔ r ɔ v ɑ
кобила	k ɔ b ɪ l̪ ɑ
наповані	n̪ ɑ p ɔ v ɑ n̪ʲ i
блукає	b l̪ u k ɑ ɛ
народних	n̪ ɑ r ɔ d̪ n̪ ɪ x
покажуть	p ɔ k ɑ ʒ u t̪
таксі	t̪ ɑ k s̪ i
Альбіні	ɑ lʲ b i n̪ʲ i
виповняється	v ɪ p ɔ v n̪ʲ ɑ ɛ t̪ s̪ ɑ
вбивцю	v b ɪ v t̪s̪ʲ u
живі	ʒ ɪ v i
мертві	m ɛ r t̪ v i
певною	p ɛ v n̪ ɔ u
Дону	d̪ ɔ n̪ u
бумага	b u m ɑ ɦ ɑ
Швеції	ʃ v ɛ t̪s̪ʲ i j i
модернізація	m ɔ d̪ ɛ r n̪ʲ i z̪ ɑ t̪s̪ʲ i ɑ
засобів	z̪ ɑ s̪ ɔ b i v
ропади	r ɔ p ɑ d̪ ɪ
навіжена	n̪ ɑ v i ʒ ɛ n̪ ɑ
шепче	ʃ ɛ p t̪ ʃ ɛ
якісної	j ɑ k i s̪ n̪ ɔ j i
преси	p r ɛ s̪ ɪ
показником	p ɔ k ɑ z̪ n̪ ɪ k ɔ m
прогнозує	p r ɔ ɦ n̪ ɔ z̪ u ɛ
діяч	d̪ʲ i ɑ t̪ ʃ
Федерер	f ɛ d̪ ɛ r ɛ r
зіграють	z̪ʲ i ɦ r ɑ u t̪
Сантьяго	s̪ ɑ n̪ t̪ ɑ ɦ ɔ
Бернабеу	b ɛ r n̪ ɑ b ɛ u
Реалу	r ɛ ɑ l̪ u
святкувати	s̪ v ɑ t̪ k u v ɑ t̪ ɪ
еліти	ɛ lʲ i t̪ ɪ
романів	r ɔ m ɑ n̪ʲ i v
болісні	b ɔ lʲ i s̪ n̪ʲ i
осередок	ɔ s̪ ɛ r ɛ d̪ ɔ k
Сумщині	s̪ u m ʃ t̪ ʃ ɪ n̪ʲ i
світовому	s̪ v i t̪ ɔ v ɔ m u
фінансовому	f i n̪ ɑ n̪ s̪ ɔ v ɔ m u
Львівського	lʲ v i v s̪ k ɔ ɦ ɔ
ллються	l̪ lʲ u t̪ s̪ ɑ
вголос	v ɦ ɔ l̪ ɔ s̪
рветься	r v ɛ t̪ s̪ ɑ
планували	p l̪ ɑ n̪ u v ɑ l̪ ɪ
Ольга	ɔ lʲ ɦ ɑ
письменника	p ɪ s̪ m ɛ n̪ n̪ ɪ k ɑ
сцену	s̪ t̪s̪ ɛ n̪ u
винних	v ɪ n̪ n̪ ɪ x
офісу	ɔ f i s̪ u
зареготалася	z̪ ɑ r ɛ ɦ ɔ t̪ ɑ l̪ ɑ s̪ ɑ
помчалася	p ɔ m t̪ ʃ ɑ l̪ ɑ s̪ ɑ
буйними	b u j n̪ ɪ m ɪ
житами	ʒ ɪ t̪ ɑ m ɪ
призведе	p r ɪ z̪ v ɛ d̪ ɛ
ретельно	r ɛ t̪ ɛ lʲ n̪ ɔ
Мінпаливенерго	m i n̪ p ɑ l̪ ɪ v ɛ n̪ ɛ r ɦ ɔ
виготовлення	v ɪ ɦ ɔ t̪ ɔ v l̪ ɛ n̪ n̪ʲ ɑ
об'єднати	ɔ b j ɛ d̪ n̪ ɑ t̪ ɪ
натерпілись	n̪ ɑ t̪ ɛ r p i l̪ ɪ s̪
загальну	z̪ ɑ ɦ ɑ lʲ n̪ u
грошових	ɦ r ɔ ʃ ɔ v ɪ x
переказів	p ɛ r ɛ k ɑ z̪ʲ i v
материне	m ɑ t̪ ɛ r ɪ n̪ ɛ
вискочить	v ɪ s̪ k ɔ t̪ ʃ ɪ t̪
запнувся	z̪ ɑ p n̪ u v s̪ ɑ
жертву	ʒ ɛ r t̪ v u
здобуде	z̪ d̪ ɔ b u d̪ ɛ
титул	t̪ ɪ t̪ u l̪
тихенько	t̪ ɪ x ɛ n̪ʲ k ɔ
питали	p ɪ t̪ ɑ l̪ ɪ
Сумської	s̪ u m s̪ k ɔ j i
розподілу	r ɔ z̪ p ɔ d̪ʲ i l̪ u
Емма	ɛ m m ɑ
Ватсон	v ɑ t̪ s̪ ɔ n̪
рекорди	r ɛ k ɔ r d̪ ɪ
зарплата	z̪ ɑ r p l̪ ɑ t̪ ɑ
приватизацію	p r ɪ v ɑ t̪ ɪ z̪ ɑ t̪s̪ʲ i u
НП	n̪ p
вчених	v t̪ ʃ ɛ n̪ ɪ x
ліки	lʲ i k ɪ
ступенів	s̪ t̪ u p ɛ n̪ʲ i v
служб	s̪ l̪ u ʒ b
заводи	z̪ ɑ v ɔ d̪ ɪ
нижче	n̪ ɪ ʒ t̪ ʃ ɛ
корупція	k ɔ r u p t̪s̪ʲ i ɑ
Батьківщини	b ɑ t̪ k i v ʃ t̪ ʃ ɪ n̪ ɪ
дітях	d̪ʲ i t̪ ɑ x
часі	t̪ ʃ ɑ s̪ i
обмеження	ɔ b m ɛ ʒ ɛ n̪ n̪ʲ ɑ
ризиків	r ɪ z̪ ɪ k i v
Хорошковського	x ɔ r ɔ ʃ k ɔ v s̪ k ɔ ɦ ɔ
розповідають	r ɔ z̪ p ɔ v i d̪ ɑ u t̪
спускає	s̪ p u s̪ k ɑ ɛ
стрічати	s̪ t̪ rʲ i t̪ ʃ ɑ t̪ ɪ
зірочки	z̪ʲ i r ɔ t̪ ʃ k ɪ
учасник	u t̪ ʃ ɑ s̪ n̪ ɪ k
адміністративних	ɑ d̪ m i n̪ʲ i s̪ t̪ r ɑ t̪ ɪ v n̪ ɪ x
намагання	n̪ ɑ m ɑ ɦ ɑ n̪ n̪ʲ ɑ
потік	p ɔ t̪ i k
посів	p ɔ s̪ i v
Головного	ɦ ɔ l̪ ɔ v n̪ ɔ ɦ ɔ
Є	j ɛ
пообіцяла	p ɔ ɔ b i t̪s̪ʲ ɑ l̪ ɑ
нахиляється	n̪ ɑ x ɪ lʲ ɑ ɛ t̪ s̪ ɑ
присутніх	p r ɪ s̪ u t̪ n̪ʲ i x
відокремлення	v i d̪ ɔ k r ɛ m l̪ ɛ n̪ n̪ʲ ɑ
віком	v i k ɔ m
приходилось	p r ɪ x ɔ d̪ ɪ l̪ ɔ s̪
сухим	s̪ u x ɪ m
хлібом	x lʲ i b ɔ m
давитись	d̪ ɑ v ɪ t̪ ɪ s̪
Південний	p i v d̪ ɛ n̪ n̪ ɪ j
патріарх	p ɑ t̪ rʲ i ɑ r x
батьківщині	b ɑ t̪ k i v ʃ t̪ ʃ ɪ n̪ʲ i
невід'ємна	n̪ ɛ v i d̪ j ɛ m n̪ ɑ
зростанням	z̪ r ɔ s̪ t̪ ɑ n̪ n̪ʲ ɑ m
університеті	u n̪ʲ i v ɛ r s̪ ɪ t̪ ɛ t̪ i
наукові	n̪ ɑ u k ɔ v i
міністерство	m i n̪ʲ i s̪ t̪ ɛ r s̪ t̪ v ɔ
рекомендує	r ɛ k ɔ m ɛ n̪ d̪ u ɛ
підручниках	p i d̪ r u t̪ ʃ n̪ ɪ k ɑ x
задала	z̪ ɑ d̪ ɑ l̪ ɑ
оця	ɔ t̪s̪ʲ ɑ
несподівана	n̪ ɛ s̪ p ɔ d̪ʲ i v ɑ n̪ ɑ
прес–конференції	p r ɛ s̪ k ɔ n̪ f ɛ r ɛ n̪ t̪s̪ʲ i j i
проведенні	p r ɔ v ɛ d̪ ɛ n̪ n̪ʲ i
плутаниця	p l̪ u t̪ ɑ n̪ ɪ t̪s̪ʲ ɑ
процедуру	p r ɔ t̪s̪ ɛ d̪ u r u
реєстрації	r ɛ ɛ s̪ t̪ r ɑ t̪s̪ʲ i j i
Укртелекому	u k r t̪ ɛ l̪ ɛ k ɔ m u
товари	t̪ ɔ v ɑ r ɪ
ростуть	r ɔ s̪ t̪ u t̪
чинним	t̪ ʃ ɪ n̪ n̪ ɪ m
някого	n̪ʲ ɑ k ɔ ɦ ɔ
сенсу	s̪ ɛ n̪ s̪ u
нафту	n̪ ɑ f t̪ u
дешевше	d̪ ɛ ʃ ɛ v ʃ ɛ
п'ятидесяти	p j ɑ t̪ ɪ d̪ ɛ s̪ ɑ t̪ ɪ
долларів	d̪ ɔ l̪ l̪ ɑ rʲ i v
барель	b ɑ r ɛ lʲ
читач	t̪ ʃ ɪ t̪ ɑ t̪ ʃ
убогі	u b ɔ ɦ i
хатини	x ɑ t̪ ɪ n̪ ɪ
доставлені	d̪ ɔ s̪ t̪ ɑ v l̪ ɛ n̪ʲ i
повеселів	p ɔ v ɛ s̪ ɛ lʲ i v
заготувала	z̪ ɑ ɦ ɔ t̪ u v ɑ l̪ ɑ
багатьма	b ɑ ɦ ɑ t̪ m ɑ
великими	v ɛ l̪ ɪ k ɪ m ɪ
агенство	ɑ ɦ ɛ n̪ s̪ t̪ v ɔ
банкрутства	b ɑ n̪ k r u t̪ s̪ t̪ v ɑ
Індії	i n̪ d̪ʲ i j i
потяг	p ɔ t̪ ɑ ɦ
Ганна	ɦ ɑ n̪ n̪ ɑ
заробили	z̪ ɑ r ɔ b ɪ l̪ ɪ
дочку	d̪ ɔ t̪ ʃ k u
московському	m ɔ s̪ k ɔ v s̪ k ɔ m u
врятували	v rʲ ɑ t̪ u v ɑ l̪ ɪ
останніми	ɔ s̪ t̪ ɑ n̪ n̪ʲ i m ɪ
Хруща	x r u ʃ t̪ ʃ ɑ
сторону	s̪ t̪ ɔ r ɔ n̪ u
створені	s̪ t̪ v ɔ r ɛ n̪ʲ i
кредиту	k r ɛ d̪ ɪ t̪ u
річеньки	rʲ i t̪ ʃ ɛ n̪ʲ k ɪ
ворога	v ɔ r ɔ ɦ ɑ
мило	m ɪ l̪ ɔ
вільної	v i lʲ n̪ ɔ j i
дерево	d̪ ɛ r ɛ v ɔ
ігор	i ɦ ɔ r
облігації	ɔ b lʲ i ɦ ɑ t̪s̪ʲ i j i
Богословська	b ɔ ɦ ɔ s̪ l̪ ɔ v s̪ k ɑ
підсумку	p i d̪ s̪ u m k u
чорт	t̪ ʃ ɔ r t̪
кіп	k i p
гороху	ɦ ɔ r ɔ x u
змолотив	z̪ m ɔ l̪ ɔ t̪ ɪ v
порівняти	p ɔ rʲ i v n̪ʲ ɑ t̪ ɪ
економічно	ɛ k ɔ n̪ ɔ m i t̪ ʃ n̪ ɔ
збирали	z̪ b ɪ r ɑ l̪ ɪ
установ	u s̪ t̪ ɑ n̪ ɔ v
Галичини	ɦ ɑ l̪ ɪ t̪ ʃ ɪ n̪ ɪ
повну	p ɔ v n̪ u
творчі	t̪ v ɔ r t̪ ʃ i
народом	n̪ ɑ r ɔ d̪ ɔ m
серйозний	s̪ ɛ r j ɔ z̪ n̪ ɪ j
містечко	m i s̪ t̪ ɛ t̪ ʃ k ɔ
родин	r ɔ d̪ ɪ n̪
міжнародна	m i ʒ n̪ ɑ r ɔ d̪ n̪ ɑ
організація	ɔ r ɦ ɑ n̪ʲ i z̪ ɑ t̪s̪ʲ i ɑ
зазначає	z̪ ɑ z̪ n̪ ɑ t̪ ʃ ɑ ɛ
поколінь	p ɔ k ɔ lʲ i n̪ʲ
кордоні	k ɔ r d̪ ɔ n̪ʲ i
отаке	ɔ t̪ ɑ k ɛ
почули	p ɔ t̪ ʃ u l̪ ɪ
геноцид	ɦ ɛ n̪ ɔ t̪s̪ ɪ d̪
тенденції	t̪ ɛ n̪ d̪ ɛ n̪ t̪s̪ʲ i j i
продавати	p r ɔ d̪ ɑ v ɑ t̪ ɪ
кардинально	k ɑ r d̪ ɪ n̪ ɑ lʲ n̪ ɔ
іти	i t̪ ɪ
одказує	ɔ d̪ k ɑ z̪ u ɛ
чують	t̪ ʃ u u t̪
біду	b i d̪ u
вижену	v ɪ ʒ ɛ n̪ u
знай	z̪ n̪ ɑ j
їздили	j i z̪ d̪ ɪ l̪ ɪ
похитнула	p ɔ x ɪ t̪ n̪ u l̪ ɑ
готове	ɦ ɔ t̪ ɔ v ɛ
визнано	v ɪ z̪ n̪ ɑ n̪ ɔ
сплеснула	s̪ p l̪ ɛ s̪ n̪ u l̪ ɑ
долоні	d̪ ɔ l̪ ɔ n̪ʲ i
символізує	s̪ ɪ m v ɔ lʲ i z̪ u ɛ
небезпеку	n̪ ɛ b ɛ z̪ p ɛ k u
матеріалами	m ɑ t̪ ɛ rʲ i ɑ l̪ ɑ m ɪ
зв'язків	z̪ v j ɑ z̪ k i v
восьми	v ɔ s̪ m ɪ
важкі	v ɑ ʒ k i
несподіваний	n̪ ɛ s̪ p ɔ d̪ʲ i v ɑ n̪ ɪ j
сум	s̪ u m
обіймає	ɔ b i j m ɑ ɛ
оцінками	ɔ t̪s̪ʲ i n̪ k ɑ m ɪ
російських	r ɔ s̪ i j s̪ k ɪ x
членство	t̪ ʃ l̪ ɛ n̪ s̪ t̪ v ɔ
вертатись	v ɛ r t̪ ɑ t̪ ɪ s̪
родіну	r ɔ d̪ʲ i n̪ u
Асоціація	ɑ s̪ ɔ t̪s̪ʲ i ɑ t̪s̪ʲ i ɑ
банків	b ɑ n̪ k i v
тарифні	t̪ ɑ r ɪ f n̪ʲ i
детальніше	d̪ ɛ t̪ ɑ lʲ n̪ʲ i ʃ ɛ
закрили	z̪ ɑ k r ɪ l̪ ɪ
змастили	z̪ m ɑ s̪ t̪ ɪ l̪ ɪ
висновку	v ɪ s̪ n̪ ɔ v k u
вогні	v ɔ ɦ n̪ʲ i
ступінь	s̪ t̪ u p i n̪ʲ
дияволи	d̪ ɪ ɑ v ɔ l̪ ɪ
тренуються	t̪ r ɛ n̪ u u t̪ s̪ ɑ
гумором	ɦ u m ɔ r ɔ m
технічний	t̪ ɛ x n̪ʲ i t̪ ʃ n̪ ɪ j
Дортмундська	d̪ ɔ r t̪ m u n̪ d̪ s̪ k ɑ
Боруссія	b ɔ r u s̪ s̪ i ɑ
орендувати	ɔ r ɛ n̪ d̪ u v ɑ t̪ ɪ
форварда	f ɔ r v ɑ r d̪ ɑ
Челсі	t̪ ʃ ɛ l̪ s̪ i
Медведєв	m ɛ d̪ v ɛ d̪ʲ ɛ v
основи	ɔ s̪ n̪ ɔ v ɪ
зазначається	z̪ ɑ z̪ n̪ ɑ t̪ ʃ ɑ ɛ t̪ s̪ ɑ
зверненні	z̪ v ɛ r n̪ ɛ n̪ n̪ʲ i
журналіста	ʒ u r n̪ ɑ lʲ i s̪ t̪ ɑ
промисловість	p r ɔ m ɪ s̪ l̪ ɔ v i s̪ t̪
захисний	z̪ ɑ x ɪ s̪ n̪ ɪ j
код	k ɔ d̪
схожі	s̪ x ɔ ʒ i
приватизувати	p r ɪ v ɑ t̪ ɪ z̪ u v ɑ t̪ ɪ
книг	k n̪ ɪ ɦ
відбулось	v i d̪ b u l̪ ɔ s̪
Аршавін	ɑ r ʃ ɑ v i n̪
функціонування	f u n̪ k t̪s̪ʲ i ɔ n̪ u v ɑ n̪ n̪ʲ ɑ
альбомі	ɑ lʲ b ɔ m i
зібрані	z̪ʲ i b r ɑ n̪ʲ i
відомого	v i d̪ ɔ m ɔ ɦ ɔ
карикатуриста	k ɑ r ɪ k ɑ t̪ u r ɪ s̪ t̪ ɑ
Юлю	j u lʲ u
шкоди	ʃ k ɔ d̪ ɪ
віччю	v i t̪ ʃ t̪ ʃ u
доправили	d̪ ɔ p r ɑ v ɪ l̪ ɪ
переваги	p ɛ r ɛ v ɑ ɦ ɪ
норма	n̪ ɔ r m ɑ
перевірити	p ɛ r ɛ v i r ɪ t̪ ɪ
особливий	ɔ s̪ ɔ b l̪ ɪ v ɪ j
підготовки	p i d̪ ɦ ɔ t̪ ɔ v k ɪ
спеціалістів	s̪ p ɛ t̪s̪ʲ i ɑ lʲ i s̪ t̪ i v
Державного	d̪ ɛ r ʒ ɑ v n̪ ɔ ɦ ɔ
американські	ɑ m ɛ r ɪ k ɑ n̪ s̪ k i
вислугу	v ɪ s̪ l̪ u ɦ u
к	k
зеленій	z̪ ɛ l̪ ɛ n̪ʲ i j
відстоювати	v i d̪ s̪ t̪ ɔ u v ɑ t̪ ɪ
ВО	v ɔ
заборонити	z̪ ɑ b ɔ r ɔ n̪ ɪ t̪ ɪ
привести	p r ɪ v ɛ s̪ t̪ ɪ
погодитися	p ɔ ɦ ɔ d̪ ɪ t̪ ɪ s̪ ɑ
ліквідувати	lʲ i k v i d̪ u v ɑ t̪ ɪ
миттєво	m ɪ t̪ t̪ ɛ v ɔ
потрапляє	p ɔ t̪ r ɑ p lʲ ɑ ɛ
світових	s̪ v i t̪ ɔ v ɪ x
хуторі	x u t̪ ɔ rʲ i
фотовиставки	f ɔ t̪ ɔ v ɪ s̪ t̪ ɑ v k ɪ
мандрують	m ɑ n̪ d̪ r u u t̪
голий	ɦ ɔ l̪ ɪ j
фанат	f ɑ n̪ ɑ t̪
автоголи	ɑ v t̪ ɔ ɦ ɔ l̪ ɪ
розгромна	r ɔ z̪ ɦ r ɔ m n̪ ɑ
Ліверпуля	lʲ i v ɛ r p u lʲ ɑ
захоплюючі	z̪ ɑ x ɔ p lʲ u u t̪ ʃ i
хімічні	x i m i t̪ ʃ n̪ʲ i
реакції	r ɛ ɑ k t̪s̪ʲ i j i
прокинулась	p r ɔ k ɪ n̪ u l̪ ɑ s̪
інвестор	i n̪ v ɛ s̪ t̪ ɔ r
Конституційного	k ɔ n̪ s̪ t̪ ɪ t̪ u t̪s̪ʲ i j n̪ ɔ ɦ ɔ
дякую	d̪ʲ ɑ k u u
слідом	s̪ lʲ i d̪ ɔ m
сотня	s̪ ɔ t̪ n̪ʲ ɑ
обрано	ɔ b r ɑ n̪ ɔ
рости	r ɔ s̪ t̪ ɪ
представника	p r ɛ d̪ s̪ t̪ ɑ v n̪ ɪ k ɑ
Кобзаря	k ɔ b z̪ ɑ rʲ ɑ
переживаємо	p ɛ r ɛ ʒ ɪ v ɑ ɛ m ɔ
найсильніша	n̪ ɑ j s̪ ɪ lʲ n̪ʲ i ʃ ɑ
елементів	ɛ l̪ ɛ m ɛ n̪ t̪ i v
побіжим	p ɔ b i ʒ ɪ m
покотимся	p ɔ k ɔ t̪ ɪ m s̪ ɑ
ковтаючи	k ɔ v t̪ ɑ u t̪ ʃ ɪ
іди	i d̪ ɪ
етнічних	ɛ t̪ n̪ʲ i t̪ ʃ n̪ ɪ x
передплати	p ɛ r ɛ d̪ p l̪ ɑ t̪ ɪ
посідаємо	p ɔ s̪ i d̪ ɑ ɛ m ɔ
побалакаємо	p ɔ b ɑ l̪ ɑ k ɑ ɛ m ɔ
розкажу	r ɔ z̪ k ɑ ʒ u
сплюнув	s̪ p lʲ u n̪ u v
писання	p ɪ s̪ ɑ n̪ n̪ʲ ɑ
зовнішньої	z̪ ɔ v n̪ʲ i ʃ n̪ʲ ɔ j i
сучасне	s̪ u t̪ ʃ ɑ s̪ n̪ ɛ
офіцерів	ɔ f i t̪s̪ ɛ rʲ i v
волості	v ɔ l̪ ɔ s̪ t̪ i
застав	z̪ ɑ s̪ t̪ ɑ v
вступної	v s̪ t̪ u p n̪ ɔ j i
економічну	ɛ k ɔ n̪ ɔ m i t̪ ʃ n̪ u
заперечує	z̪ ɑ p ɛ r ɛ t̪ ʃ u ɛ
наявність	n̪ ɑ ɑ v n̪ʲ i s̪ t̪
Міноборони	m i n̪ ɔ b ɔ r ɔ n̪ ɪ
маленька	m ɑ l̪ ɛ n̪ʲ k ɑ
кругленька	k r u ɦ l̪ ɛ n̪ʲ k ɑ
швидка	ʃ v ɪ d̪ k ɑ
жвава	ʒ v ɑ v ɑ
різко	rʲ i z̪ k ɔ
тією	t̪ i ɛ u
вдався	v d̪ ɑ v s̪ ɑ
старт	s̪ t̪ ɑ r t̪
заслужений	z̪ ɑ s̪ l̪ u ʒ ɛ n̪ ɪ j
їхали	j i x ɑ l̪ ɪ
конфлікту	k ɔ n̪ f lʲ i k t̪ u
відкривають	v i d̪ k r ɪ v ɑ u t̪
горобенят	ɦ ɔ r ɔ b ɛ n̪ʲ ɑ t̪
заступника	z̪ ɑ s̪ t̪ u p n̪ ɪ k ɑ
навкруги	n̪ ɑ v k r u ɦ ɪ
блискучими	b l̪ ɪ s̪ k u t̪ ʃ ɪ m ɪ
вивчали	v ɪ v t̪ ʃ ɑ l̪ ɪ
творах	t̪ v ɔ r ɑ x
подорожчав	p ɔ d̪ ɔ r ɔ ʒ t̪ ʃ ɑ v
наука	n̪ ɑ u k ɑ
Це	t̪s̪ ɛ
фірм	f i r m
відношення	v i d̪ n̪ ɔ ʃ ɛ n̪ n̪ʲ ɑ
шапку	ʃ ɑ p k u
військову	v i j s̪ k ɔ v u
концепцію	k ɔ n̪ t̪s̪ ɛ p t̪s̪ʲ i u
вдень	v d̪ ɛ n̪ʲ
возитиму	v ɔ z̪ ɪ t̪ ɪ m u
снопи	s̪ n̪ ɔ p ɪ
праця	p r ɑ t̪s̪ʲ ɑ
умовами	u m ɔ v ɑ m ɪ
витягла	v ɪ t̪ ɑ ɦ l̪ ɑ
скрині	s̪ k r ɪ n̪ʲ i
сувої	s̪ u v ɔ j i
полотна	p ɔ l̪ ɔ t̪ n̪ ɑ
Валя	v ɑ lʲ ɑ
вродлива	v r ɔ d̪ l̪ ɪ v ɑ
галушок	ɦ ɑ l̪ u ʃ ɔ k
зварити	z̪ v ɑ r ɪ t̪ ɪ
синім	s̪ ɪ n̪ʲ i m
шатром	ʃ ɑ t̪ r ɔ m
розіп'ялось	r ɔ z̪ʲ i p j ɑ l̪ ɔ s̪
небо	n̪ ɛ b ɔ
поблідла	p ɔ b lʲ i d̪ l̪ ɑ
визначені	v ɪ z̪ n̪ ɑ t̪ ʃ ɛ n̪ʲ i
заборгованості	z̪ ɑ b ɔ r ɦ ɔ v ɑ n̪ ɔ s̪ t̪ i
транзит	t̪ r ɑ n̪ z̪ ɪ t̪
жонатим	ʒ ɔ n̪ ɑ t̪ ɪ m
Присяжнюк	p r ɪ s̪ ɑ ʒ n̪ʲ u k
шалений	ʃ ɑ l̪ ɛ n̪ ɪ j
поранив	p ɔ r ɑ n̪ ɪ v
особисту	ɔ s̪ ɔ b ɪ s̪ t̪ u
нашими	n̪ ɑ ʃ ɪ m ɪ
вивести	v ɪ v ɛ s̪ t̪ ɪ
Лягла	lʲ ɑ ɦ l̪ ɑ
Падав	p ɑ d̪ ɑ v
дрібний	d̪ rʲ i b n̪ ɪ j
Стів	s̪ t̪ i v
Джобс	d̪ ʒ ɔ b s̪
Apple	a p p l̪ ɛ
відомства	v i d̪ ɔ m s̪ t̪ v ɑ
Тарас	t̪ ɑ r ɑ s̪
НБА	n̪ b ɑ
дісталася	d̪ʲ i s̪ t̪ ɑ l̪ ɑ s̪ ɑ
підписання	p i d̪ p ɪ s̪ ɑ n̪ n̪ʲ ɑ
вражає	v r ɑ ʒ ɑ ɛ
різноманітністю	rʲ i z̪ n̪ ɔ m ɑ n̪ʲ i t̪ n̪ʲ i s̪ t̪ u
виділити	v ɪ d̪ʲ i l̪ ɪ t̪ ɪ
змаганнях	z̪ m ɑ ɦ ɑ n̪ n̪ʲ ɑ x
затряслась	z̪ ɑ t̪ rʲ ɑ s̪ l̪ ɑ s̪
осичині	ɔ s̪ ɪ t̪ ʃ ɪ n̪ʲ i
розіслало	r ɔ z̪ʲ i s̪ l̪ ɑ l̪ ɔ
зелений	z̪ ɛ l̪ ɛ n̪ ɪ j
килим	k ɪ l̪ ɪ m
сміється	s̪ m i ɛ t̪ s̪ ɑ
ворогів	v ɔ r ɔ ɦ i v
бідно	b i d̪ n̪ ɔ
Христя	x r ɪ s̪ t̪ ɑ
коцюби	k ɔ t̪s̪ʲ u b ɪ
передбачити	p ɛ r ɛ d̪ b ɑ t̪ ʃ ɪ t̪ ɪ
популяція	p ɔ p u lʲ ɑ t̪s̪ʲ i ɑ
амурських	ɑ m u r s̪ k ɪ x
тигрів	t̪ ɪ ɦ rʲ i v
спала	s̪ p ɑ l̪ ɑ
робимо	r ɔ b ɪ m ɔ
постив	p ɔ s̪ t̪ ɪ v
п'ятниць	p j ɑ t̪ n̪ ɪ t̪s̪ʲ
злочин	z̪ l̪ ɔ t̪ ʃ ɪ n̪
віддав	v i d̪ d̪ ɑ v
місцева	m i s̪ t̪s̪ ɛ v ɑ
знаходив	z̪ n̪ ɑ x ɔ d̪ ɪ v
купила	k u p ɪ l̪ ɑ
коника	k ɔ n̪ ɪ k ɑ
коник	k ɔ n̪ ɪ k
Рівненської	rʲ i v n̪ ɛ n̪ s̪ k ɔ j i
законодавство	z̪ ɑ k ɔ n̪ ɔ d̪ ɑ v s̪ t̪ v ɔ
банківської	b ɑ n̪ k i v s̪ k ɔ j i
відповідну	v i d̪ p ɔ v i d̪ n̪ u
Антимонопольний	ɑ n̪ t̪ ɪ m ɔ n̪ ɔ p ɔ lʲ n̪ ɪ j
Рахункова	r ɑ x u n̪ k ɔ v ɑ
палата	p ɑ l̪ ɑ t̪ ɑ
Закарпаття	z̪ ɑ k ɑ r p ɑ t̪ t̪ ɑ
атаці	ɑ t̪ ɑ t̪s̪ʲ i
попнешся	p ɔ p n̪ ɛ ʃ s̪ ɑ
соціальна	s̪ ɔ t̪s̪ʲ i ɑ lʲ n̪ ɑ
Запорізького	z̪ ɑ p ɔ rʲ i z̪ʲ k ɔ ɦ ɔ
облуправління	ɔ b l̪ u p r ɑ v lʲ i n̪ n̪ʲ ɑ
МінНС	m i n̪ n̪ s̪
потрібну	p ɔ t̪ rʲ i b n̪ u
кредиторів	k r ɛ d̪ ɪ t̪ ɔ rʲ i v
основна	ɔ s̪ n̪ ɔ v n̪ ɑ
стадіоні	s̪ t̪ ɑ d̪ʲ i ɔ n̪ʲ i
повіз	p ɔ v i z̪
одягнена	ɔ d̪ʲ ɑ ɦ n̪ ɛ n̪ ɑ
зелене	z̪ ɛ l̪ ɛ n̪ ɛ
убрання	u b r ɑ n̪ n̪ʲ ɑ
справжніх	s̪ p r ɑ v ʒ n̪ʲ i x
продам	p r ɔ d̪ ɑ m
аршини	ɑ r ʃ ɪ n̪ ɪ
Ощадбанку	ɔ ʃ t̪ ʃ ɑ d̪ b ɑ n̪ k u
Укрексімбанку	u k r ɛ k s̪ i m b ɑ n̪ k u
Укргазбанку	u k r ɦ ɑ z̪ b ɑ n̪ k u
повели	p ɔ v ɛ l̪ ɪ
повів	p ɔ v i v
статусу	s̪ t̪ ɑ t̪ u s̪ u
наголошує	n̪ ɑ ɦ ɔ l̪ ɔ ʃ u ɛ
одчепись	ɔ d̪ t̪ ʃ ɛ p ɪ s̪
стрель	s̪ t̪ r ɛ lʲ
стрельнув	s̪ t̪ r ɛ lʲ n̪ u v
звідкіля	z̪ v i d̪ k i lʲ ɑ
заведемо	z̪ ɑ v ɛ d̪ ɛ m ɔ
бесіду	b ɛ s̪ i d̪ u
дев'яти	d̪ ɛ v j ɑ t̪ ɪ
тинятимешся	t̪ ɪ n̪ʲ ɑ t̪ ɪ m ɛ ʃ s̪ ɑ
військовий	v i j s̪ k ɔ v ɪ j
чинник	t̪ ʃ ɪ n̪ n̪ ɪ k
форумі	f ɔ r u m i
оголошено	ɔ ɦ ɔ l̪ ɔ ʃ ɛ n̪ ɔ
судового	s̪ u d̪ ɔ v ɔ ɦ ɔ
майно	m ɑ j n̪ ɔ
квартет	k v ɑ r t̪ ɛ t̪
сценах	s̪ t̪s̪ ɛ n̪ ɑ x
театрів	t̪ ɛ ɑ t̪ rʲ i v
принесла	p r ɪ n̪ ɛ s̪ l̪ ɑ
звістку	z̪ v i s̪ t̪ k u
наводить	n̪ ɑ v ɔ d̪ ɪ t̪
суперліга	s̪ u p ɛ r lʲ i ɦ ɑ
Будівельник	b u d̪ʲ i v ɛ lʲ n̪ ɪ k
познущався	p ɔ z̪ n̪ u ʃ t̪ ʃ ɑ v s̪ ɑ
основою	ɔ s̪ n̪ ɔ v ɔ u
магія	m ɑ ɦ i ɑ
чисел	t̪ ʃ ɪ s̪ ɛ l̪
чарівний	t̪ ʃ ɑ rʲ i v n̪ ɪ j
геометрії	ɦ ɛ ɔ m ɛ t̪ rʲ i j i
краса	k r ɑ s̪ ɑ
стрункість	s̪ t̪ r u n̪ k i s̪ t̪
алгебри	ɑ l̪ ɦ ɛ b r ɪ
воював	v ɔ u v ɑ v
сербськими	s̪ ɛ r b s̪ k ɪ m ɪ
партизанами	p ɑ r t̪ ɪ z̪ ɑ n̪ ɑ m ɪ
виборами	v ɪ b ɔ r ɑ m ɪ
малюнки	m ɑ lʲ u n̪ k ɪ
розсунули	r ɔ z̪ s̪ u n̪ u l̪ ɪ
душно	d̪ u ʃ n̪ ɔ
млосно	m l̪ ɔ s̪ n̪ ɔ
пече	p ɛ t̪ ʃ ɛ
попід	p ɔ p i d̪
боками	b ɔ k ɑ m ɪ
сторінках	s̪ t̪ ɔ rʲ i n̪ k ɑ x
східна	s̪ x i d̪ n̪ ɑ
НУНС	n̪ u n̪ s̪
скласти	s̪ k l̪ ɑ s̪ t̪ ɪ
компанію	k ɔ m p ɑ n̪ʲ i u
посадових	p ɔ s̪ ɑ d̪ ɔ v ɪ x
квадратних	k v ɑ d̪ r ɑ t̪ n̪ ɪ x
вирядили	v ɪ rʲ ɑ d̪ ɪ l̪ ɪ
Остапа	ɔ s̪ t̪ ɑ p ɑ
піст	p i s̪ t̪
гриби	ɦ r ɪ b ɪ
найефективніші	n̪ ɑ j ɛ f ɛ k t̪ ɪ v n̪ʲ i ʃ i
Національне	n̪ ɑ t̪s̪ʲ i ɔ n̪ ɑ lʲ n̪ ɛ
корпоративне	k ɔ r p ɔ r ɑ t̪ ɪ v n̪ ɛ
звинувачення	z̪ v ɪ n̪ u v ɑ t̪ ʃ ɛ n̪ n̪ʲ ɑ
різноманітні	rʲ i z̪ n̪ ɔ m ɑ n̪ʲ i t̪ n̪ʲ i
пошуки	p ɔ ʃ u k ɪ
випереджають	v ɪ p ɛ r ɛ d̪ ʒ ɑ u t̪
раза	r ɑ z̪ ɑ
енергетичної	ɛ n̪ ɛ r ɦ ɛ t̪ ɪ t̪ ʃ n̪ ɔ j i
міському	m i s̪ k ɔ m u
оголосив	ɔ ɦ ɔ l̪ ɔ s̪ ɪ v
хочете	x ɔ t̪ ʃ ɛ t̪ ɛ
настільки	n̪ ɑ s̪ t̪ i lʲ k ɪ
територію	t̪ ɛ r ɪ t̪ ɔ rʲ i u
золотий	z̪ ɔ l̪ ɔ t̪ ɪ j
дубль	d̪ u b lʲ
єдиної	j ɛ d̪ ɪ n̪ ɔ j i
перейшов	p ɛ r ɛ j ʃ ɔ v
живу	ʒ ɪ v u
стіною	s̪ t̪ i n̪ ɔ u
Фіорентини	f i ɔ r ɛ n̪ t̪ ɪ n̪ ɪ
реагує	r ɛ ɑ ɦ u ɛ
покупки	p ɔ k u p k ɪ
Національного	n̪ ɑ t̪s̪ʲ i ɔ n̪ ɑ lʲ n̪ ɔ ɦ ɔ
Генпрокуратура	ɦ ɛ n̪ p r ɔ k u r ɑ t̪ u r ɑ
натяг	n̪ ɑ t̪ ɑ ɦ
ряднину	rʲ ɑ d̪ n̪ ɪ n̪ u
особистості	ɔ s̪ ɔ b ɪ s̪ t̪ ɔ s̪ t̪ i
вічний	v i t̪ ʃ n̪ ɪ j
приводом	p r ɪ v ɔ d̪ ɔ m
Горлач	ɦ ɔ r l̪ ɑ t̪ ʃ
пам'ятати	p ɑ m j ɑ t̪ ɑ t̪ ɪ
степу	s̪ t̪ ɛ p u
розколу	r ɔ z̪ k ɔ l̪ u
продукту	p r ɔ d̪ u k t̪ u
шле	ʃ l̪ ɛ
старостів	s̪ t̪ ɑ r ɔ s̪ t̪ i v
бідної	b i d̪ n̪ ɔ j i
некрасивої	n̪ ɛ k r ɑ s̪ ɪ v ɔ j i
дівчини	d̪ʲ i v t̪ ʃ ɪ n̪ ɪ
тутешніх	t̪ u t̪ ɛ ʃ n̪ʲ i x
заснула	z̪ ɑ s̪ n̪ u l̪ ɑ
прядучи	p rʲ ɑ d̪ u t̪ ʃ ɪ
згорнувши	z̪ ɦ ɔ r n̪ u v ʃ ɪ
пухлі	p u x lʲ i
ліктями	lʲ i k t̪ ɑ m ɪ
дванадцяти	d̪ v ɑ n̪ ɑ d̪ t̪s̪ʲ ɑ t̪ ɪ
поміж	p ɔ m i ʒ
громадянами	ɦ r ɔ m ɑ d̪ʲ ɑ n̪ ɑ m ɪ
відпочити	v i d̪ p ɔ t̪ ʃ ɪ t̪ ɪ
сигнал	s̪ ɪ ɦ n̪ ɑ l̪
головного	ɦ ɔ l̪ ɔ v n̪ ɔ ɦ ɔ
пункт	p u n̪ k t̪
висвітлення	v ɪ s̪ v i t̪ l̪ ɛ n̪ n̪ʲ ɑ
протистояти	p r ɔ t̪ ɪ s̪ t̪ ɔ ɑ t̪ ɪ
реалізацію	r ɛ ɑ lʲ i z̪ ɑ t̪s̪ʲ i u
душею	d̪ u ʃ ɛ u
приходом	p r ɪ x ɔ d̪ ɔ m
Олексію	ɔ l̪ ɛ k s̪ i u
залишились	z̪ ɑ l̪ ɪ ʃ ɪ l̪ ɪ s̪
Кеті	k ɛ t̪ i
президентів	p r ɛ z̪ ɪ d̪ ɛ n̪ t̪ i v
далекому	d̪ ɑ l̪ ɛ k ɔ m u
бійтеся	b i j t̪ ɛ s̪ ɑ
хороша	x ɔ r ɔ ʃ ɑ
основним	ɔ s̪ n̪ ɔ v n̪ ɪ m
міграції	m i ɦ r ɑ t̪s̪ʲ i j i
запропонувати	z̪ ɑ p r ɔ p ɔ n̪ u v ɑ t̪ ɪ
згадаймо	z̪ ɦ ɑ d̪ ɑ j m ɔ
бодай	b ɔ d̪ ɑ j
близьких	b l̪ ɪ z̪ʲ k ɪ x
поетів	p ɔ ɛ t̪ i v
поліцейських	p ɔ lʲ i t̪s̪ ɛ j s̪ k ɪ x
здійснює	z̪ d̪ʲ i j s̪ n̪ʲ u ɛ
труби	t̪ r u b ɪ
зрозуміло	z̪ r ɔ z̪ u m i l̪ ɔ
обридло	ɔ b r ɪ d̪ l̪ ɔ
горювати	ɦ ɔ rʲ u v ɑ t̪ ɪ
скрикнули	s̪ k r ɪ k n̪ u l̪ ɪ
Державної	d̪ ɛ r ʒ ɑ v n̪ ɔ j i
Світлана	s̪ v i t̪ l̪ ɑ n̪ ɑ
порадившись	p ɔ r ɑ d̪ ɪ v ʃ ɪ s̪
Мотрею	m ɔ t̪ r ɛ u
десятника	d̪ ɛ s̪ ɑ t̪ n̪ ɪ k ɑ
ступня	s̪ t̪ u p n̪ʲ ɑ
напрямків	n̪ ɑ p rʲ ɑ m k i v
райвідділі	r ɑ j v i d̪ d̪ʲ i lʲ i
особі	ɔ s̪ ɔ b i
втікти	v t̪ i k t̪ ɪ
вислуга	v ɪ s̪ l̪ u ɦ ɑ
косити	k ɔ s̪ ɪ t̪ ɪ
відіграє	v i d̪ʲ i ɦ r ɑ ɛ
важливу	v ɑ ʒ l̪ ɪ v u
становило	s̪ t̪ ɑ n̪ ɔ v ɪ l̪ ɔ
необхідне	n̪ ɛ ɔ b x i d̪ n̪ ɛ
творчої	t̪ v ɔ r t̪ ʃ ɔ j i
офіційної	ɔ f i t̪s̪ʲ i j n̪ ɔ j i
руда	r u d̪ ɑ
свиня	s̪ v ɪ n̪ʲ ɑ
увернув	u v ɛ r n̪ u v
змалку	z̪ m ɑ l̪ k u
оздоровлення	ɔ z̪ d̪ ɔ r ɔ v l̪ ɛ n̪ n̪ʲ ɑ
розповідала	r ɔ z̪ p ɔ v i d̪ ɑ l̪ ɑ
принципи	p r ɪ n̪ t̪s̪ ɪ p ɪ
дорогах	d̪ ɔ r ɔ ɦ ɑ x
прочитала	p r ɔ t̪ ʃ ɪ t̪ ɑ l̪ ɑ
козацька	k ɔ z̪ ɑ t̪s̪ʲ k ɑ
старшина	s̪ t̪ ɑ r ʃ ɪ n̪ ɑ
опустила	ɔ p u s̪ t̪ ɪ l̪ ɑ
компанія	k ɔ m p ɑ n̪ʲ i ɑ
літаків	lʲ i t̪ ɑ k i v
перевірку	p ɛ r ɛ v i r k u
Табачника	t̪ ɑ b ɑ t̪ ʃ n̪ ɪ k ɑ
ціні	t̪s̪ʲ i n̪ʲ i
вічно	v i t̪ ʃ n̪ ɔ
класно	k l̪ ɑ s̪ n̪ ɔ
Гаррі	ɦ ɑ r rʲ i
живих	ʒ ɪ v ɪ x
думаєш	d̪ u m ɑ ɛ ʃ
програвши	p r ɔ ɦ r ɑ v ʃ ɪ
сучасними	s̪ u t̪ ʃ ɑ s̪ n̪ ɪ m ɪ
кожним	k ɔ ʒ n̪ ɪ m
ролі	r ɔ lʲ i
ініціативою	i n̪ʲ i t̪s̪ʲ i ɑ t̪ ɪ v ɔ u
знижку	z̪ n̪ ɪ ʒ k u
відкритий	v i d̪ k r ɪ t̪ ɪ j
Олександра	ɔ l̪ ɛ k s̪ ɑ n̪ d̪ r ɑ
плаче	p l̪ ɑ t̪ ʃ ɛ
ДПА	d̪ p ɑ
країнами	k r ɑ j i n̪ ɑ m ɪ
розташований	r ɔ z̪ t̪ ɑ ʃ ɔ v ɑ n̪ ɪ j
поверсі	p ɔ v ɛ r s̪ i
корпусу	k ɔ r p u s̪ u
суперником	s̪ u p ɛ r n̪ ɪ k ɔ m
подалася	p ɔ d̪ ɑ l̪ ɑ s̪ ɑ
личком	l̪ ɪ t̪ ʃ k ɔ m
Москву	m ɔ s̪ k v u
страху	s̪ t̪ r ɑ x u
зроду	z̪ r ɔ d̪ u
АЗС	ɑ z̪ s̪
пільгових	p i lʲ ɦ ɔ v ɪ x
категорій	k ɑ t̪ ɛ ɦ ɔ rʲ i j
думавши	d̪ u m ɑ v ʃ ɪ
заіскрили	z̪ ɑ i s̪ k r ɪ l̪ ɪ
ринки	r ɪ n̪ k ɪ
доходів	d̪ ɔ x ɔ d̪ʲ i v
баби	b ɑ b ɪ
спожитий	s̪ p ɔ ʒ ɪ t̪ ɪ j
подарували	p ɔ d̪ ɑ r u v ɑ l̪ ɪ
згодився	z̪ ɦ ɔ d̪ ɪ v s̪ ɑ
апарату	ɑ p ɑ r ɑ t̪ u
порівняння	p ɔ rʲ i v n̪ʲ ɑ n̪ n̪ʲ ɑ
варіанти	v ɑ rʲ i ɑ n̪ t̪ ɪ
проаналізувати	p r ɔ ɑ n̪ ɑ lʲ i z̪ u v ɑ t̪ ɪ
словник	s̪ l̪ ɔ v n̪ ɪ k
перевернувся	p ɛ r ɛ v ɛ r n̪ u v s̪ ɑ
зберігання	z̪ b ɛ rʲ i ɦ ɑ n̪ n̪ʲ ɑ
Барселона	b ɑ r s̪ ɛ l̪ ɔ n̪ ɑ
Реал	r ɛ ɑ l̪
сильніші	s̪ ɪ lʲ n̪ʲ i ʃ i
Наполі	n̪ ɑ p ɔ lʲ i
роздивлявся	r ɔ z̪ d̪ ɪ v lʲ ɑ v s̪ ɑ
боки	b ɔ k ɪ
хокей	x ɔ k ɛ j
НХЛ	n̪ x l̪
Анахайм	ɑ n̪ ɑ x ɑ j m
здолало	z̪ d̪ ɔ l̪ ɑ l̪ ɔ
Колорадо	k ɔ l̪ ɔ r ɑ d̪ ɔ
поскаржитись	p ɔ s̪ k ɑ r ʒ ɪ t̪ ɪ s̪
коментар	k ɔ m ɛ n̪ t̪ ɑ r
трусов	t̪ r u s̪ ɔ v
національного	n̪ ɑ t̪s̪ʲ i ɔ n̪ ɑ lʲ n̪ ɔ ɦ ɔ
Києвом	k ɪ ɛ v ɔ m
мерседес	m ɛ r s̪ ɛ d̪ ɛ s̪
СНД	s̪ n̪ d̪
старої	s̪ t̪ ɑ r ɔ j i
попередньою	p ɔ p ɛ r ɛ d̪ n̪ʲ ɔ u
особа	ɔ s̪ ɔ b ɑ
прозивався	p r ɔ z̪ ɪ v ɑ v s̪ ɑ
Притика	p r ɪ t̪ ɪ k ɑ
сталого	s̪ t̪ ɑ l̪ ɔ ɦ ɔ
територій	t̪ ɛ r ɪ t̪ ɔ rʲ i j
продають	p r ɔ d̪ ɑ u t̪
непотрібних	n̪ ɛ p ɔ t̪ rʲ i b n̪ ɪ x
Мілош	m i l̪ ɔ ʃ
Красіч	k r ɑ s̪ i t̪ ʃ
переходить	p ɛ r ɛ x ɔ d̪ ɪ t̪
районного	r ɑ j ɔ n̪ n̪ ɔ ɦ ɔ
спиться	s̪ p ɪ t̪ s̪ ɑ
Грицька	ɦ r ɪ t̪s̪ʲ k ɑ
юних	j u n̪ ɪ x
регіон	r ɛ ɦ i ɔ n̪
огородина	ɔ ɦ ɔ r ɔ d̪ ɪ n̪ ɑ
контракту	k ɔ n̪ t̪ r ɑ k t̪ u
судові	s̪ u d̪ ɔ v i
худоба	x u d̪ ɔ b ɑ
напована	n̪ ɑ p ɔ v ɑ n̪ ɑ
блукаю	b l̪ u k ɑ u
забув	z̪ ɑ b u v
церквою	t̪s̪ ɛ r k v ɔ u
секретар	s̪ ɛ k r ɛ t̪ ɑ r
звіті	z̪ v i t̪ i
солодкі	s̪ ɔ l̪ ɔ d̪ k i
гіркі	ɦ i r k i
сільськогосподарської	s̪ i lʲ s̪ k ɔ ɦ ɔ s̪ p ɔ d̪ ɑ r s̪ k ɔ j i
надає	n̪ ɑ d̪ ɑ ɛ
життям	ʒ ɪ t̪ t̪ ɑ m
недалечке	n̪ ɛ d̪ ɑ l̪ ɛ t̪ ʃ k ɛ
чуже	t̪ ʃ u ʒ ɛ
літньої	lʲ i t̪ n̪ʲ ɔ j i
сусідах	s̪ u s̪ i d̪ ɑ x
удвох	u d̪ v ɔ x
старою	s̪ t̪ ɑ r ɔ u
німецькі	n̪ʲ i m ɛ t̪s̪ʲ k i
сумі	s̪ u m i
розшук	r ɔ z̪ ʃ u k
постояв	p ɔ s̪ t̪ ɔ ɑ v
трішки	t̪ rʲ i ʃ k ɪ
виграла	v ɪ ɦ r ɑ l̪ ɑ
всеукраїнського	v s̪ ɛ u k r ɑ j i n̪ s̪ k ɔ ɦ ɔ
домовилися	d̪ ɔ m ɔ v ɪ l̪ ɪ s̪ ɑ
росіянами	r ɔ s̪ i ɑ n̪ ɑ m ɪ
секретаріат	s̪ ɛ k r ɛ t̪ ɑ rʲ i ɑ t̪
Балога	b ɑ l̪ ɔ ɦ ɑ
ліквідовані	lʲ i k v i d̪ ɔ v ɑ n̪ʲ i
злочинної	z̪ l̪ ɔ t̪ ʃ ɪ n̪ n̪ ɔ j i
депортації	d̪ ɛ p ɔ r t̪ ɑ t̪s̪ʲ i j i
транзиту	t̪ r ɑ n̪ z̪ ɪ t̪ u
тезу	t̪ ɛ z̪ u
вкотре	v k ɔ t̪ r ɛ
доводять	d̪ ɔ v ɔ d̪ʲ ɑ t̪
дотримання	d̪ ɔ t̪ r ɪ m ɑ n̪ n̪ʲ ɑ
громадянство	ɦ r ɔ m ɑ d̪ʲ ɑ n̪ s̪ t̪ v ɔ
намагалася	n̪ ɑ m ɑ ɦ ɑ l̪ ɑ s̪ ɑ
вбити	v b ɪ t̪ ɪ
вогонь	v ɔ ɦ ɔ n̪ʲ
неодноразово	n̪ ɛ ɔ d̪ n̪ ɔ r ɑ z̪ ɔ v ɔ
вели	v ɛ l̪ ɪ
леді	l̪ ɛ d̪ʲ i
зміну	z̪ m i n̪ u
дитинство	d̪ ɪ t̪ ɪ n̪ s̪ t̪ v ɔ
чотирнадцятого	t̪ ʃ ɔ t̪ ɪ r n̪ ɑ d̪ t̪s̪ʲ ɑ t̪ ɔ ɦ ɔ
окружного	ɔ k r u ʒ n̪ ɔ ɦ ɔ
заплановано	z̪ ɑ p l̪ ɑ n̪ ɔ v ɑ n̪ ɔ
Остапом	ɔ s̪ t̪ ɑ p ɔ m
хірурги	x i r u r ɦ ɪ
педіатри	p ɛ d̪ʲ i ɑ t̪ r ɪ
стоматологи	s̪ t̪ ɔ m ɑ t̪ ɔ l̪ ɔ ɦ ɪ
продовольчої	p r ɔ d̪ ɔ v ɔ lʲ t̪ ʃ ɔ j i
генеральний	ɦ ɛ n̪ ɛ r ɑ lʲ n̪ ɪ j
платежів	p l̪ ɑ t̪ ɛ ʒ i v
вітчизняного	v i t̪ t̪ ʃ ɪ z̪ n̪ʲ ɑ n̪ ɔ ɦ ɔ
озброєнних	ɔ z̪ b r ɔ ɛ n̪ n̪ ɪ x
спини	s̪ p ɪ n̪ ɪ
розгинаючи	r ɔ z̪ ɦ ɪ n̪ ɑ u t̪ ʃ ɪ
спочивку	s̪ p ɔ t̪ ʃ ɪ v k u
знаючи	z̪ n̪ ɑ u t̪ ʃ ɪ
любив	lʲ u b ɪ v
яктаки	j ɑ k t̪ ɑ k ɪ
повірити	p ɔ v i r ɪ t̪ ɪ
волоцюзі	v ɔ l̪ ɔ t̪s̪ʲ u z̪ʲ i
правоохоронні	p r ɑ v ɔ ɔ x ɔ r ɔ n̪ n̪ʲ i
короткій	k ɔ r ɔ t̪ k i j
прийдуть	p r ɪ j d̪ u t̪
спільна	s̪ p i lʲ n̪ ɑ
Папи	p ɑ p ɪ
Павла	p ɑ v l̪ ɑ
ІІ	i i
власник	v l̪ ɑ s̪ n̪ ɪ k
інформує	i n̪ f ɔ r m u ɛ
Мєдвєдєва	m ɛ d̪ v ɛ d̪ʲ ɛ v ɑ
чергова	t̪ ʃ ɛ r ɦ ɔ v ɑ
прогнозами	p r ɔ ɦ n̪ ɔ z̪ ɑ m ɪ
заплатив	z̪ ɑ p l̪ ɑ t̪ ɪ v
співак	s̪ p i v ɑ k
відзначити	v i d̪ z̪ n̪ ɑ t̪ ʃ ɪ t̪ ɪ
ідентичність	i d̪ ɛ n̪ t̪ ɪ t̪ ʃ n̪ʲ i s̪ t̪
транспортних	t̪ r ɑ n̪ s̪ p ɔ r t̪ n̪ ɪ x
пари	p ɑ r ɪ
виступу	v ɪ s̪ t̪ u p u
валюту	v ɑ lʲ u t̪ u
Дякую	d̪ʲ ɑ k u u
підтримував	p i d̪ t̪ r ɪ m u v ɑ v
журнал	ʒ u r n̪ ɑ l̪
посол	p ɔ s̪ ɔ l̪
заводу	z̪ ɑ v ɔ d̪ u
Федір	f ɛ d̪ʲ i r
експлуатації	ɛ k s̪ p l̪ u ɑ t̪ ɑ t̪s̪ʲ i j i
сучасній	s̪ u t̪ ʃ ɑ s̪ n̪ʲ i j
роком	r ɔ k ɔ m
Мотре	m ɔ t̪ r ɛ
маса	m ɑ s̪ ɑ
інтересами	i n̪ t̪ ɛ r ɛ s̪ ɑ m ɪ
усміхаючись	u s̪ m i x ɑ u t̪ ʃ ɪ s̪
запрохуючи	z̪ ɑ p r ɔ x u u t̪ ʃ ɪ
тиском	t̪ ɪ s̪ k ɔ m
проведеного	p r ɔ v ɛ d̪ ɛ n̪ ɔ ɦ ɔ
змагання	z̪ m ɑ ɦ ɑ n̪ n̪ʲ ɑ
уявлення	u ɑ v l̪ ɛ n̪ n̪ʲ ɑ
додаткової	d̪ ɔ d̪ ɑ t̪ k ɔ v ɔ j i
емісії	ɛ m i s̪ i j i
найголовніше	n̪ ɑ j ɦ ɔ l̪ ɔ v n̪ʲ i ʃ ɛ
доступу	d̪ ɔ s̪ t̪ u p u
публічної	p u b lʲ i t̪ ʃ n̪ ɔ j i
здурів	z̪ d̪ u rʲ i v
збожеволів	z̪ b ɔ ʒ ɛ v ɔ lʲ i v
зведення	z̪ v ɛ d̪ ɛ n̪ n̪ʲ ɑ
діячі	d̪ʲ i ɑ t̪ ʃ i
поділилися	p ɔ d̪ʲ i l̪ ɪ l̪ ɪ s̪ ɑ
рядків	rʲ ɑ d̪ k i v
поїде	p ɔ j i d̪ ɛ
Максима	m ɑ k s̪ ɪ m ɑ
з'явилося	z̪ j ɑ v ɪ l̪ ɔ s̪ ɑ
зерно	z̪ ɛ r n̪ ɔ
передала	p ɛ r ɛ d̪ ɑ l̪ ɑ
загального	z̪ ɑ ɦ ɑ lʲ n̪ ɔ ɦ ɔ
фондів	f ɔ n̪ d̪ʲ i v
чисто	t̪ ʃ ɪ s̪ t̪ ɔ
глянути	ɦ lʲ ɑ n̪ u t̪ ɪ
зеленіє	z̪ ɛ l̪ ɛ n̪ʲ i ɛ
спогади	s̪ p ɔ ɦ ɑ d̪ ɪ
кріпацької	k rʲ i p ɑ t̪s̪ʲ k ɔ j i
зовнішньополітичної	z̪ ɔ v n̪ʲ i ʃ n̪ʲ ɔ p ɔ lʲ i t̪ ɪ t̪ ʃ n̪ ɔ j i
неодмінно	n̪ ɛ ɔ d̪ m i n̪ n̪ ɔ
особистість	ɔ s̪ ɔ b ɪ s̪ t̪ i s̪ t̪
нестандартні	n̪ ɛ s̪ t̪ ɑ n̪ d̪ ɑ r t̪ n̪ʲ i
математичні	m ɑ t̪ ɛ m ɑ t̪ ɪ t̪ ʃ n̪ʲ i
фізичні	f i z̪ ɪ t̪ ʃ n̪ʲ i
сенсаційні	s̪ ɛ n̪ s̪ ɑ t̪s̪ʲ i j n̪ʲ i
Чикаго	t̪ ʃ ɪ k ɑ ɦ ɔ
Майамі	m ɑ j ɑ m i
мріє	m rʲ i ɛ
крапка	k r ɑ p k ɑ
повернутись	p ɔ v ɛ r n̪ u t̪ ɪ s̪
споживач	s̪ p ɔ ʒ ɪ v ɑ t̪ ʃ
ЧФ	t̪ ʃ f
цінностей	t̪s̪ʲ i n̪ n̪ ɔ s̪ t̪ ɛ j
тричі	t̪ r ɪ t̪ ʃ i
установи	u s̪ t̪ ɑ n̪ ɔ v ɪ
маршрутки	m ɑ r ʃ r u t̪ k ɪ
Харківщині	x ɑ r k i v ʃ t̪ ʃ ɪ n̪ʲ i
